"aa" = (/obj/machinery/door/window/northright,/obj/machinery/door/window/southleft,/turf/open/floor/tiled,/area/bluespaceriver/ship)
"ab" = (/turf/open/mask{temperature = 230},/area/bluespaceriver/ground)
"ac" = (/obj/machinery/vending/boozeomat,/turf/open/space/basic,/area/bluespaceriver/ship)
"ad" = (/obj/structure/flora/grass/brown,/turf/open/floor/plating/asteroid/snow{temperature = 240},/area/bluespaceriver/ground)
"ae" = (/obj/structure/flora/tree/pine,/turf/open/floor/plating/asteroid/snow{temperature = 240},/area/bluespaceriver/ground)
"af" = (/obj/structure/flora/bush,/turf/open/floor/plating/asteroid/snow{temperature = 240},/area/bluespaceriver/ground)
"ag" = (/obj/structure/flora/bush,/obj/structure/flora/grass/both,/turf/open/floor/plating/asteroid/snow{temperature = 240},/area/bluespaceriver/ground)
"ah" = (/obj/structure/flora/grass/green,/turf/open/floor/plating/asteroid/snow{temperature = 240},/area/bluespaceriver/ground)
"ai" = (/obj/structure/flora/grass/both,/turf/open/floor/plating/asteroid/snow{temperature = 240},/area/bluespaceriver/ground)
"aj" = (/obj/structure/flora/ausbushes/brflowers,/turf/open/floor/plating/asteroid/snow{temperature = 240},/area/bluespaceriver/ground)
"ak" = (/obj/machinery/smartfridge/chemistry,/turf/open/space/basic,/area/bluespaceriver/ship)
"al" = (/turf/closed/wall,/area/bluespaceriver/ship)
"am" = (/obj/machinery/power/apc{dir = 8; pixel_x = -24},/obj/structure/cable{icon_state = "0-2"; d2 = 2},/turf/open/floor/tiled,/area/bluespaceriver/ship)
"an" = (/obj/structure/cable,/turf/open/floor/tiled,/area/bluespaceriver/ship)
"ao" = (/obj/machinery/computer/monitor,/turf/open/floor/tiled,/area/bluespaceriver/ship)
"ap" = (/obj/machinery/computer/security,/turf/open/floor/tiled,/area/bluespaceriver/ship)
"aq" = (/obj/machinery/computer/station_alert,/turf/open/floor/tiled,/area/bluespaceriver/ship)
"ar" = (/obj/machinery/computer/atmos_alert,/turf/open/floor/tiled,/area/bluespaceriver/ship)
"as" = (/obj/machinery/light{dir = 1},/obj/structure/closet/wardrobe/science_white,/turf/open/floor/tiled,/area/bluespaceriver/ship)
"at" = (/obj/structure/table/reinforced,/turf/open/floor/tiled,/area/bluespaceriver/ship)
"au" = (/obj/structure/closet/radiation,/turf/open/floor/tiled,/area/bluespaceriver/ship)
"av" = (/obj/machinery/shieldwallgen,/turf/open/floor/tiled,/area/bluespaceriver/ship)
"aw" = (/obj/structure/sign/warning/vacuum,/turf/open/floor/tiled,/area/bluespaceriver/ship)
"ax" = (/obj/machinery/light{dir = 8},/turf/open/floor/tiled,/area/bluespaceriver/ship)
"ay" = (/obj/structure/ore_box,/turf/open/floor/tiled,/area/bluespaceriver/ship)
"aB" = (/obj/machinery/door/airlock/command,/turf/open/floor/tiled,/area/bluespaceriver/ship)
"aD" = (/obj/machinery/computer/rdconsole,/turf/open/floor/tiled,/area/bluespaceriver/ship)
"aE" = (/obj/machinery/light{dir = 1},/turf/open/floor/tiled,/area/bluespaceriver/ship)
"aG" = (/obj/machinery/door/airlock/science,/turf/open/floor/tiled,/area/bluespaceriver/ship)
"aI" = (/obj/item/pizzabox,/obj/machinery/light{dir = 1},/turf/open/floor/tiled,/area/bluespaceriver/ship)
"aS" = (/obj/machinery/microwave,/turf/open/floor/tiled,/area/bluespaceriver/ship)
"aV" = (/obj/machinery/chem_master,/turf/open/floor/tiled,/area/bluespaceriver/ship)
"ba" = (/turf/open/floor/plating,/area/bluespaceriver/ship)
"bh" = (/obj/structure/closet/emcloset,/turf/open/floor/tiled,/area/bluespaceriver/ship)
"bj" = (/obj/machinery/light,/obj/structure/filingcabinet,/turf/open/floor/tiled,/area/bluespaceriver/ship)
"bp" = (/obj/machinery/autolathe,/turf/open/floor/tiled,/area/bluespaceriver/ship)
"bq" = (/obj/machinery/light,/turf/open/floor/tiled,/area/bluespaceriver/ship)
"bA" = (/obj/structure/table/glass,/turf/open/floor/tiled,/area/bluespaceriver/ship)
"bE" = (/obj/machinery/door/airlock,/turf/open/floor/tiled,/area/bluespaceriver/ship)
"bF" = (/obj/machinery/light{dir = 4; icon_state = "tube1"},/turf/open/floor/tiled,/area/bluespaceriver/ship)
"bH" = (/obj/structure/bookcase/manuals/research_and_development,/turf/open/floor/tiled,/area/bluespaceriver/ship)
"cb" = (/turf/open/floor/tiled,/area/bluespaceriver/ship)
"cy" = (/obj/structure/ladder,/turf/open/floor/plating/asteroid/snow{temperature = 240},/area/bluespaceriver/ground)
"cA" = (/obj/structure/flora/grass/both,/obj/structure/flora/grass/both,/turf/open/floor/plating/asteroid/snow{temperature = 240},/area/bluespaceriver/ground)
"cB" = (/obj/structure/flora/grass/both,/obj/structure/flora/bush,/turf/open/floor/plating/asteroid/snow{temperature = 240},/area/bluespaceriver/ground)
"cC" = (/turf/open/floor/plating/asteroid/snow{temperature = 240},/area/bluespaceriver/ground)
"cD" = (/turf/open/floor/mineral{temperature = 233},/area/bluespaceriver/ground)

(1,1,1) = {"
cDcDcDcDcDcDcDcDcDcDcDcDcDcDcDcDcDcDcDcDcDcDcDcDcDcDcDcDcDcDcDcDcDcDcDcDcDcDcDcDcDcDcDcDcDcDcDcDcDcDcDcDcDcDcDcDcDcDcDcDcDcDcDcDcDcDcDcDcDcDcDcDcDcDcDcDcDcDcDcDcDcDcDcDcDcDcDcDcDcDcDcDcDcDcDcDcDcDcDcD
cDababababababababababababababababababababababababababababababababababababababababababababababababababababababababababababababababababababababababababababababababababababababababababababababababababcD
cDababababababababababababababababababababababababababababababababababababababababababababababababababababababababababababababababababababababababababababababababababababababababababababababababababcD
cDababababababababababababababababababababababababababababababababababababababababababababababababababababababababababababababababababababababababababababababababababababababababababababababababababcD
cDababababababababababababababababababababababababababababababababababababababababababababababababababababababababababababababababababababababababababababababababababababababababababababababababababcD
cDababababababababababababababababababababababababababababababababababababababababababababababababababababababababababababababababababababababababababababababababababababababababababababababababababcD
cDababababababababababababababababababababababababababababababababababababababcCcCcCabababababababababababababababababababababababababababababababababababababababababababababababababababababababababcD
cDababababababababababababababababababababababababababababababababcCcCcCcCcCababcCcCababababababcCabababcCcCcCcCcCababababababababababababababababababababababababababababababababababababababababababcD
cDababababababababababababababababababababababababababababababababcCcCcCcCcCcCabcCcCcCcCcCabababcCabcCadcCcCcCcCaecCababababababababcCabababcCcCcCcCcCcCcCababababababababababababababababababababababcD
cDababababababababababababababababababababababababababababababcCcCcCcCcCaecCcCcCcCcCcCcCcCababcCcCcCcCcCcCcCcCcCcCcCababababababababcCabababcCcCcCcCcCcCcCcCabababababababababababababababababababababcD
cDababababababababababababababababababababababababababababababcCcCcCcCcCcCcCcCcCcCcCcCcCaecCabcCcCcCcCcCcCcCcCcCcCcCcCcCabababcCcCcCcCababababcCcCcCcCcCcCcCcCababababababababababababababababababababcD
cDababababababababababababababcCcCcCcCcCcCababababcCabababababcCcCcCcCcCcCcCcCcCcCcCcCcCafcCcCcCcCcCcCcCcCcCcCcCcCcCcCababababcCcCcCcCcCabcCabcCcCcCcCcCcCababababababababababababababababababababababcD
cDababababababababababababababcCcCcCcCcCcCcCabababcCcCcCcCcCaecCcCcCcCcCcCcCcCcCadcCcCcCcCcCcCcCcCcCcCcCcCcCcCcCcCcCcCababcCcCcCcCcCcCcCcCcCcCcCcCcCcCcCcCababababababababababababababababababababababcD
cDababababababababababababababcCcCcCcCagcCcCabababcCcCcCcCcCcCcCcCcCahcCcCcCadcCcCcCcCcCcCcCcCcCcCcCcCcCcCcCcCcCcCcCcCcCcCcCcCcCcCcCcCcCcCcCcCcCcCcCcCcCcCababababababababababababababababababababababcD
cDababababababababababababababcCcCcCcCcCcCcCcCcCcCcCcCaicCcCcCcCcCcCcCcCcCcCcCcCcCcCcCcCcCcCcCcCcCcCcCcCadcCcCcCcCcCcCcCcCcCcCcCcCcCcCcCcCcCcCcCcCcCcCcCcCababcCcCcCabcCcCababababababababababababababcD
cDababababababababababababababcCcCcCcCcCcCcCcCcCcCcCcCcCcCcCcCcCcCcCcCcCcCcCcCcCcCcCcCcCcCcCcCcCcCcCcCcCcCcCcCcCcCcCcCcCcCcCcCcCadcCcCcCcCcCcCcCcCcCadcCcCcCcCcCcCcCcCcCababcCababababababababababababcD
cDababababababababababababcCcCcCcCcCcCcCcCcCcCcCcCcCcCcCafcCcCcCcCcCcCcCcCcCcCcCcCcCcCcCcCcCcCcCcCcCcCcCcCcCcCcCcCcCcCcCcCcCcCcCcCcCcCcCcCcCcCcCcCcCcCcCcCcCcCcCcCcCcCcCabcCcCcCcCababababababababababcD
cDababababababababababababcCcCcCcCcCcCcCcCcCcCcCcCcCcCcCcCcCcCcCcCcCcCcCcCcCcCcCcCcCcCafcCcCcCcCcCcCcCcCadcCcCcCcCcCcCcCcCcCcCcCcCcCcCcCcCcCcCcCcCcCcCcCcCcCcCcCcCcCcCcCcCcCcCcCcCababababababababababcD
cDababababababababababababcCcCcCcCcCcCcCcCaecCaicCcCcCcCcCcCcCcCcCcCcCcCcCcCcCafcCcCcCcCcCafcCcCcCcCcCcCcCcCcCcCcCcCcCcCcCcCcCcCcCcCcCcCcCcCcCcCcCcCcCcCcCcCcCcCcCcCcCcCcCcCcCcCcCcCabababababababababcD
cDababababababababababababcCcCcCcCcCcCafcCahcCcCaicCcCcCcCcCcCcCcCcCcCcCcCafaecCcCcCcCcCcCcCcCcCcCcCcCcCcCcCcCcCcCcCcCcCcCcCcCcCaecCcCcCcCcCcCcCcCcCcCcCcCcCcCcCcCcCcCcCcCcCcCcCabababababababababababcD
cDababababababababababababcCcCcCcCcCcCcCcCcCcCcCcCcCcCcCcCcCcCcCcCcCcCcCcCcCcCcCcCcCcCcCcCcCcCcCcCcCcCcCcCcCcCcCcCcCcCcCcCcCcCcCcCcCcCcCcCcCcCcCcCcCcCcCcCcCcCcCcCcCcCcCcCcCcCaicCcCabababababababababcD
cDabababababababababababcCcCcCcCafcCcCcCcCcCcCcCcCcCcCcCcCcCcCcCcCcCcCcCafcCcCcCcCcCcCcCcCcCcCcCcCcCcCcCcCcCcCcCcCcCcCcCcCcCcCcCcCcCcCcCcCcCcCcCaicCcCcCcCcCcCcCcCcCcCcCcCcCcCcCcCababababababababababcD
cDabababababababababababcCcCcCafcCcCcCcCcCcCcCcCcCcCcCcCcCcCcCcCafcCcCcCcCcCafcCcCcCcCcCcCcCcCcCcCcCcCcCcCcCcCcCcCcCcCcCcCcCcCcCcCcCcCcCcCcCcCcCcCcCcCcCcCcCcCcCcCcCcCcCcCcCcCcCabababababababababababcD
cDabababababababababababcCcCcCcCcCcCcCcCcCcCcCcCcCcCcCcCcCcCcCcCcCcCcCcCcCcCcCcCcCcCcCcCcCcCafcCcCcCcCcCcCcCcCcCcCcCcCcCcCcCcCcCcCcCcCcCcCcCcCcCcCcCcCaecCcCcCcCcCcCcCcCcCcCcCcCcCababababababababababcD
cDabababababababababababcCcCcCcCcCcCcCcCcCcCcCcCajcCcCcCcCcCcCcCcCcCcCcCcCcCcCcCcCcCcCcCcCcCcCcCcCcCcCcCcCcCcCcCcCcCcCcCcCcCcCcCcCcCcCcCcCcCcCcCcCcCcCcCcCcCcCcCcCcCcCcCcCcCcCcCcCababababababababababcD
cDababababababababababababcCcCcCcCcCcCcCcCcCcCcCcCcCcCcCcCadcCcCcCcCcCcCcCcCcCcCcCafcCcCaicCcCcCcCcCcCcCcCcCcCcCcCcCcCcCcCcCcCcCcCcCcCcCcCcCcCcCcCcCcCcCcCcCcCcCcCcCcCcCcCcCcCcCcCcCcCababababababababcD
cDababababababababababcCcCcCcCcCcCcCcCcCcCcCcCcCcCcCcCcCcCcCcCcCaecCcCcCcCcCcCcCcCcCcCcCcCcCcCcCcCcCcCcCcCcCcCcCcCcCcCcCcCcCcCcCcCcCcCcCcCcCaicCcCcCcCcCcCcCcCcCcCcCcCcCcCcCcCcCcCcCabababababababababcD
cDababababababababcCcCcCcCcCcCcCcCcCcCcCcCcCcCcCcCcCcCcCcCcCcCcCcCcCcCcCcCcCcCcCcCcCcCcCcCaicCcCcCcCcCcCcCcCcCcCcCcCcCcCcCcCcCcCcCcCcCcCcCcCcCcCcCcCcCcCcCcCadcCcCcCaeaicCcCcCcCcCababababababababababcD
cDababababababababcCcCcCcCcCcCcCcCcCcCcCcCcCcCcCcCcCcCcCcCcCcCcCcCcCcCcCcCcCcCcCcCcCcCcCcCcCcCcCcCcCcCcCcCcCcCcCcCcCcCcCcCcCcCcCcCcCcCcCcCcCcCcCcCcCcCcCcCcCcCcCcCcCcCcCcCcCcCcCcCcCabababababababababcD
cDababababababababcCcCcCcCcCcCcCcCcCcCcCalalalalalalalcCcCcCcCcCcCcCcCcCahcCcCcCcCcCcCcCcCcCcCcCcCcCcCcCcCcCcCcCcCcCcCcCcCcCcCcCcCcCcCcCcCcCcCcCcCcCcCcCcCcCcCcCcCcCcCcCcCcCcCcCabababababababababababcD
cDababababababcCcCcCcCcCcCcCcCcCcCcCcCbaalaoapaqararalalcCcCcCcCcCcCcCcCcCcCcCcCcCcCcCcCcCcCcCcCcCcCcCcCcCcCcCcCcCcCcCcCcCcCcCcCcCcCcCcCcCcCcCcCcCcCcCcCcCcCcCcCcCcCcCcCcCcCcCababababababababababababcD
cDabababababababcCcCcCcCcCcCcCcCcCcCalalatcbcbcbbqcbcbalalcCcCcCcCcCcCcCcCcCcCcCcCcCcCcCcCcCcCcCcCcCcCcCcCcCcCcCcCcCcCcCcCcCcCcCcCcCcCcCcCcCcCcCcCcCcCcCcCcCcCcCcCcCcCcCcCcCcCcCcCababababababababababcD
cDabababababcCabcCcCcCcCcCcCcCcCcCalalcbcbcbcbcbcbcbaBacalalcCcCcCcCcCcCcCcCcCcCcCcCcCcCcCcCcCcCcCcCcCcCcCcCcCcCcCcCcCcCcCcCcCcCcCcCcCcCcCcCcCcCcCcCcCcCcCcCcCcCcCcCcCcCcCcCcCcCcCababababababababababcD
cDabababababcCcCcCcCcCcCcCcCcCcCalalaDaEcbaGcbaIcbcbcbcbcbalalcCcCcCcCcCcCcCcCcCahcCcCcCcCcCcCcCcCcCcCcCcCcCcCcCcCcCcCcCcCcCcCcCafcCcCcCcCcCcCcCcCcCcCcCcCcCcCcCcCcCcCcCcCcCcCcCcCababababababababababcD
cDababababababcCcCcCcCcCcCcCcCalalcbcbcbcbakcbcbcbcbcbcbcbaSalalcCcCcCcCcCcCcCcCcCcCaecCcCcCcCcCcCcCcCcCcCcCcCcCcCcCcCcCcCcCcCcCcCcCcCcCcCcCcCcCcCcCcCcCcCcCcCcCcCcCcCcCcCcCcCcCcCababababababababababcD
cDababababababcCcCcCcCcCcCcCalalcbcbcbcbaVcbcbcbcbcbcbcbcbbFcbalalcCcCcCcCcCcCcCcCcCcCcCcCcCcCcCcCahcCcCcCcCcCcCcCcCcCcCcCcCcCcCcCcCcCcCcCcCcCcCcCcCcCcCcCcCcCcCcCcCcCcCcCaecCcCcCababababababababababcD
cDababababababcCcCcCcCcCcCalalcbcbcbbFcbcbcbcbbhcbcbbjcbcbcbcbcbalalcCcCcCcCcCcCcCcCaicCcCcCcCcCcCcCcCcCcCcCcCcCcCcCcCcCcCcCcCcCcCcCcCcCcCcCcCcCcCcCcCcCcCcCcCcCcCcCcCcCcCcCcCcCcCababababababababababcD
cDababababababcCcCcCcCcCalalbpcbcbbqcbcbcbbEcbcbcbcbcbcbcbcbaGcbbAalalcCcCcCcCcCcCcCcCcCcCcCcCcCcCcCcCcCcCcCcCcCcCcCcCcCcCcCcCcCcCcCcCcCcCcCcCcCcCcCcCcCcCcCcCcCcCcCcCcCcCcCcCcCcCababababababababababcD
cDababababababcCcCcCcCcCalcbcbcbaacbcbcbcbcbbEcbcbcbcbcbcbbFcbcbcbcbalcCcCcCcCcCcCcCcCcCcCcCcCcCcCcCcCcCcCcCcCcCcCcCcCcCcCcCcCcCcCcCcCcCcCcCcCcCcCcCcCcCcCcCcCcCcCcCcCcCcCcCcCcCcCcCcCababababababababcD
cDababababababcCcCcCcCcCalcbcbcbcbcbaDaEcbaGcbaIcbcbcbcbcbcbcbcbcbcbalcCcCcCcCcCcCcCcCcCcCcCcCcCcCcCcCcCcCcCcCcCcCaicCcCcCcCcCcCcCcCcCcCcCcCcCcCcCcCcCcCcCcCcCcCcCcCcCcCcCcCcCcCcCcCabababababababababcD
cDabababababcCcCcCcCcCcCalcbcbcbcbcbcbcbcbakcbcbcbcbcbcbcbaScbcbcbcbalcCcCcCaicCcCcCcCcCcCcCcCcCcCcCcCcCafcCcCcCcCaicCcCcCcCcCcCcCcCcCcCcCcCcCcCcCcCcCcCcCcCcCcCcCcCcCcCcCcCcCcCcCcCabababababababababcD
cDabababababcCcCcCcCcCcCalcbcbcbcbcbcbcbaVcbcbcbcbcbcbcbcbbFcbcbcbcbalcCcCcCcCcCcCcCcCcCcCcCaicCcCcCcCcCcCcCcCcCcCcCcCcCcCcCcCcCcCcCcCcCcCcCcCcCcCcCcCcCcCcCaicCcCcCcCcCcCcCcCcCcCcCcCcCabababababababcD
cDabababababcCcCcCcCcCcCalcbcbcbcbcbbFcbcbcbcbbhcbcbbjcbcbcbcbcbcbcbalcCcCcCcCcCcCcCcCcCcCcCcCcCcCcCcCcCcCcCcCcCcCcCcCcCcCcCcCcCcCcCcCcCcCcCcCcCcCcCcCcCcCcCcCcCcCcCcCcCcCcCcCcCcCcCcCababababababababcD
cDabababababcCcCadcCcCcCalcbbpcbcbbqcbcbcbbEcbcbcbcbcbcbcbcbaGcbbAcbalcCcCcCcCcCcCcCcCcCcCcCcCcCcCcCcCcCcCaecCcCcCcCcCcCcCcCcCcCafcCcCcCcCcCcCcCcCcCcCcCcCcCcCcCcCcCcCcCcCcCcCcCcCcCabababababababababcD
cDababababababcCcCcCcCcCalcbcbcbaacbcbcbcbcbbEcbcbcbcbcbcbbFcbcbcbcbalcCcCcCcCcCcCcCcCcCcCcCcCcCcCcCcCcCcCcCcCcCcCcCaicCcCcCcCcCcCcCcCcCcCcCcCcCcCcCcCcCcCcCcCcCcCcCcCcCcCcCcCcCcCcCabababababababababcD
cDababababababcCcCcCcCcCalcbcbcbcbcbcbbHcbcbcbcbcbcbcbbHcbamcbcbcbcbalcCcCcCcCcCcCcCcCcCcCcCcCcCcCcCcCcCcCcCcCcCcCcCcCcCcCcCcCcCcCcCcCcCcCcCcCcCcCaecCcCcCcCcCcCcCcCcCcCcCcCcCcCcCcCcCababababababababcD
cDababababababcCcCcCcCcCalalcbcbcbcbcbcbcbcbcbcbcbcbcbcbcbancbcbcbalalcCcCcCcCcCcCcCcCcCcCahcCcCcCcCcCcCcCcCcCcCcCcCcCcCcCcCcCcCcCcCcCcCcCcCcCcCcCcCcCcCcCcCcCcCcCcCcCcCcCcCcCaicCaiabababababababababcD
cDababababcCcCcCcCcCcCcCcCalalcbcbcbcbbHcbcbcbcbcbcbcbcbcbcbcbcbalalcCcCcCcCcCcCcCcCcCcCcCcCcCcCcCcCcCcCcCcCcCcCcCcCcCcCcCcCcCcCafcCcCcCcCcCcCcCaicCcCcCcCcCcCcCaicCcCcCcCcCcCcCcCcCabababababababababcD
cDababababcCcCcCcCcCcCcCcCcCalalcbcbcbcbcbcbcbcbcbcbcbcbcbcbcbalalcCcCcCcCcCcCcCcCcCcCcCcCcCcCcCcCcCcCcCcCcCcCcCcCcCcCcCcCcCcCcCcCcCcCcCcCcCcCaiaicCcCcCcCcCcCcCcCcCcCcCcCcCcCcCcCcCcCababababababababcD
cDababababababahcCcCcCcCcCcCcCalalcbcbcbasaucbcbcbcbaEcbcbcbalalcCcCcCcCcCcCcCcCcCcCcCcCcCcCcCcCcCcCcCcCcCcCcCcCcCcCcCcCcCcCcCcCcCcCcCcCcCcCcCcCcCcCcCcCcCcCcCaicCcCcCcCcCcCcCcCcCcCcCababababababababcD
cDabababababababcCcCcCcCcCcCcCcCalalcbcbcbcbavavcbcbcbcbcbalalcCcCcCcCcCcCcCcCcCcCcCcCcCcCcCcCcCcCcCcCcCcCcCcCaicCcCcCcCcCcCcCcCcCcCcCcCcCcCcCcCcCcCcCcCcCcCcCcCcCcCcCcCcCcCcCcCcCcCcCababababababababcD
cDabababababababababcCcCcCcCcCcCcCbaalcbcbcbcbcbcbcbcbbFalalcCcCcCcCcCcCcCcCcCcCcCcCcCcCcCcCcCcCcCcCcCcCcCcCcCcCcCaecCcCcCcCcCcCcCcCcCcCcCcCcCcCcCcCcCcCcCcCcCcCcCcCcCcCcCcCcCcCcCcCcCcCabababababababcD
cDabababababababababcCcCcCcCcCcCcCcCalcbawaxcbcbcbcbcbayalcCcCcCcCcCcCcCcCcCcCcCcCcCcCcCcCcCcCcCcCcCcCcCcCcCcCcCcCcCcCcCcCcCcCcCcCcCaicCcCcCcCcCcCcCcCcCcCcCcCcCcCcCcCcCcCcCcCcCcCcCabababababababababcD
cDabababababababababcCcCcCcCcCcCcCcCalalalalalbaalalalalalcCcCcCcCcCcCcCcCcCcCcCcCcCcCcCcCcCcCcCcCcCcCcCcCcCcCcCcCcCcCcCcCcCcCcCcCcCcCcCcCcCcCcCcCcCcCcCcCcCcCcCcCcCcCcCcCcCcCcCcCcCabababababababababcD
cDabababababababababcCcCcCcCcCcCcCcCcCcCcCcCcCcCcCcCcCcCcCcCcCcCcCcCcCcCcCcCcCcCcCcCcCcCcCcCcCcCcCcCcCcCcCcCcCcCcCcCcCcCcCcCcCcCcCcCcCcCcCcCcCcCcCcCcCcCcCcCcCcCcCcCcCcCcCcCcCcCcCcCabababababababababcD
cDabababababababababcCcCcCcCcCcCcCcCcCcCcCcCcCcCcCcCcCcCcCcCcCcCcCcCcCcCcCcCcCcCcCcCcCcCcCcCcCcCcCcCcCcCcCcCcCcCcCcCcCcCcCcCcCcCcCcCcCcCcCcCcCcCcCcCcCcCcCcCcCcCcCcCcCcCcCcCcCcCabababababababababababcD
cDababababababababababcCcCcCcCcCcCcCcCcCcCcCcycCcCcCcCcCcCcCcCcCcCcCcCcCcCcCcCcCcCcCcCcCcCcCcCcCcCcCcCcCcCcCcCcCcCcCcCcCcCcCcCcCcCcCcCcCcCcCcCcCcCcCcCcCcCcCcCcCcCcCcCcCcCcCcCcCcCababababababababababcD
cDababababababababababcCahcCcCcCcCcCcCcCcCcCcCcCcCcCcCcCcCcCcCcCcCcCcCcCcCcCcCcCcCcCcCcCcCcCcCcCcCcCcCcCcCcCcCcCcCcCcCcCcCcCcCcCcCcCcCcCcCcCcCcCcCcCcCcCcCcCcCcCcCcCcCcCcCcCcCcCabababababababababababcD
cDababababababcCcCcCcCcCcCcCcCcCcCcCcCcCcCcCcCcCcCcCcCcCcCcCcCcCcCcCcCcCcCcCcCcCcCcCcCcCcCcCcCcCcCcCcCcCcCcCcCcCaecCcCcCcCcCcCcCcCcCcCcCcCcCcCcCcCcCcCcCcCcCcCcCcCcCcCcCcCcCcCababababababababababababcD
cDabababababcCcCcCcCcCcCcCcCcCcCcCcCcCcCcCcCcCcCcCcCcCcCcCcCcCcCcCcCcCcCcCcCcCcCcCcCcCcCcCcCcCcCcCcCcCcCcCcCcCcCcCcCcCcCcCcCcCcCcCcCcCcCcCcCcCcCcCcCcCcCcCcCcCcCcCcCcCcCaecCcCcCcCcCabababababababababcD
cDababababababcCcCcCcCcCcCcCcCcCcCcCcCcCcCcCcCcCcCcCcCcCcCcCcCcCcCcCcCcCcCaicCcCcCcCcCcCcCcCcCcCcCcCcCcCcCcCcCcCcCcCcCcCcCcCcCcCcCcCcCcCcCcCcCcCcCcCcCcCcCcCcCcCcCcCcCcCcCcCcCcCcCcCcCcCabababababababcD
cDabababababcCcCcCcCcCcCcCcCcCcCcCcCcCcCcCcCcCcCcCcCcCcCcCcCcCcCcCcCcCcCcCcCcCcCcCcCcCcCcCcCcCcCcCcCcCcCcCcCcCcCcCcCcCcCcCcCcCcCcCcCcCcCcCcCcCcCcCcCcCcCcCcCcCcCcCcCcCcCcCcCcCcCcCcCcCcCabababababababcD
cDababababcCcCcCcCcCcCcCcCcCcCcCcCcCcCcCcCcCcCcCcCcCcCafcCcCcCcCcCcCcCcCcCcCcCcCcCcCcCcCcCcCcCcCcCcCcCcCcCcCcCcCcCcCcCcCcCcCcCcCcCcCcCcCcCcCcCcCcCcCcCcCcCcCcCcCcCcCcCcCcCcCcCcCcCcCcCcCabababababababcD
cDababababcCcCcCcCcCcCcCcCcCcCcCcCcCcCcCcCcCcCcCcCcCcCcCcCcCcCcCcCcCcCcCcCcCcCcCcCcCcCcCcCcCcCcCcCcCcCcCcCcCcCcCcCcCcCcCcCcCcCcCcCcCcCcCcCcCcCcCcCcCcCcCcCcCcCcCcCcCcCcCcCcCcCcCcCcCabababababababababcD
cDababababcCabcCcCcCcCcCcCaicCcCcAcCcBcCcCcCcCcCcCcCcCcCcCcCcCcCcCcCcCcCcCcCcCcCcCcCcCcCcCcCcCcCcCcCcCcCcCcCcCcCcCcCcCcCcCcCcCcCcCcCcCcCcCcCcCcCcCcCcCcCcCcCcCcCcCcCcCcCcCcCcCcCcCcCabababababababababcD
cDababababababcCaicCcCcCcCcCcCcCcCcCcCcCcCcCcCcCcCcCcCcCcCcCcCcCcCcCcCcCcCcCcCcCcCcCaecCcCcCcCcCcCcCcCcCcCcCcCaicCcCcCcCcCcCcCcCcCcCcCcCcCcCcCcCcCcCcCcCcCcCcCcCcCcCcCcCcCcCcCcCcCababababababababababcD
cDababababababcCcCcCcCcCcCcCcCcCcCcCcCcCcCcCcCcCcCcCcCcCcCcCcCcCcCcCcCcCcCcCcCcCcCcCcCcCcCcCcCcCcCcCcCcCcCcCcCcCcCcCcCcCcCcCcCcCcCcCcCcCcCcCcCcCcCcCcCcCcCcCcCcCcCcCcCcCcCcCcCcCcCababababababababababcD
cDabababababcCcCcCcCcCcCcCcCcCcCcCcCcCcCcCcCcCcCcCcCcCcCcCcCcCcCcCcCcCcCcCcCcCcCcCcCcCcCcCcCcCcCcCcCcCcCcCcCcCcCcCcCcCcCcCcCcCcCcCcCcCcCcCcCcCcCcCcCcCcCcCcCcCcCcCcCcCcCcCcCcCcCcCcCabababababababababcD
cDababababcCcCcCcCcCcCcCcCcCcCcCcCcCcCcCcCcCcCcCcCcCcCcCcCcCcCcCcCcCcCcCcCcCcCcCcCcCcCcCcCcCcCcCcCcCcCcCcCcCcCcCcCcCcCcCcCcCcCcCcCcCcCcCcCcCcCcCcCcCcCcCcCcCcCcCcCcCcCcCcCcCcCcCcCcCcCcCabababababababcD
cDabababababcCcCcCcCcCcCcCcCcCcCcCafcCcCcCcCcCcCcCcCcCcCcCcCcCcCcCcCcCcCcCcCcCaicCcCcCcCcCcCcCcCcCcCcCcCcCcCcCcCcCaecCcCcCcCcCcCcCcCcCcCcCcCcCcCcCcCcCcCcCcCcCcCcCcCaecCcCcCcCcCcCcCcCcCabababababababcD
cDabababababcCcCcCcCcCcCcCcCcCcCcCcCcCcCcCcCcCaicCcCcCcCcCcCcCcCcCcCcCcCcCcCcCcCcCcCcCafaicCcCcCcCcCcCcCcCcCcCcCcCcCcCcCcCcCcCcCcCcCcCcCcCcCcCcCcCcCcCcCcCcCcCcCcCcCcCcCcCcCcCcCcCaicCcCcCababababababcD
cDabababababcCcCcCafcCcCcCcCcCcCcCcCcCcCcCcCcCcCcCcCcCcCcCcCcCcCcCcCcCcCcCcCcCcCcCcCcCcCcCcCcCcCcCcCcCcCcCcCcCcCcCcCcCcCcCcCcCcCcCcCcCcCcCcCcCcCcCcCcCcCcCcCcCcCcCcCcCcCcCcCcCcCcCcCcCcCabababababababcD
cDabababababcCcCcCcCcCcCcCcCcCaecCcCcCcCcCcCcCcCcCcCcCcCcCcCcCcCcCcCcCcCcCcCcCcCcCcCcCcCcCcCcCcCcCcCcCcCcCcCcCcCcCcCcCcCcCcCcCcCcCcCcCcCcCcCcCcCcCcCcCcCcCcCcCcCcCcCcCcCcCcCcCcCcCcCcCcCabababababababcD
cDabababababcCcCcCcCcCcCcCcCcCcCcCcCcCcCaicCcCcCcCcCcCcCcCcCcCcCcCcCcCcCcCcCcCcCcCcCcCcCcCcCcCcCcCcCcCcCcCcCcCcCcCcCcCcCcCcCcCcCcCcCcCcCcCcCcCcCcCcCcCcCcCcCcCcCcCcCcCcCcCcCcCcCcCcCcCababababababababcD
cDabababababcCcCcCcCcCcCcCcCcCcCcCcCcCaicCcCcCcCcCcCcCcCcCcCcCcCcCcCcCcCcCcCcCcCcCcCcCcCcCcCcCcCcCcCcCcCcCcCcCcCcCcCcCcCcCcCcCcCcCcCcCcCcCcCcCcCcCcCcCcCcCcCcCcCcCcCcCcCcCcCcCcCcCcCcCababababababababcD
cDabababababcCcCcCcCcCcCcCcCcCcCcCcCcCcCcCcCcCcCcCcCcCcCcCcCcCaicCcCcCcCcCcCcCcCcCcCcCcCcCcCcCcCcCcCcCcCaecCcCcCcCcCcCcCcCcCcCcCcCcCcCcCcCcCcCcCcCcCcCcCcCcCcCcCcCcCcCcCcCcCcCcCcCcCabababababababababcD
cDababababababcCcCcCcCcCcCcCcCcCcCcCcCcCcCcCcCcCcCcCcCcCcCcCcCcCcCcCaicCaecCcCcCcCcCcCcCcCcCcCcCcCcCcCcCaicCaicCcCcCcCcCcCcCcCcCcCcCcCcCcCcCcCcCcCcCcCcCcCcCcCcCcCcCcCcCcCcCcCabcCababababababababababcD
cDababababababcCcCcCcCcCcCcCcCcCcCcCcCcCcCcCcCcCcCcCcCcCcCcCcCcCcCcCcCcCcCcCcCcCcCcCcCcCcCcCcCcCcCcCcCcCcCcCcCcCcCcCcCcCcCcCcCcCcCcCcCcCcCcCcCcCcCcCcCcCcCcCcCcCcCcCcCcCcCcCcCababababababababababababcD
cDababababababcCcCcCcCcCcCcCcCcCcCcCcCcCcCcCcCcCcCcCcCcCcCcCcCcCcCcCcCcCcCcCcCcCcCcCcCcCcCcCcCcCcCcCcCcCcCcCcCcCcCcCcCcCcCcCcCcCcCcCcCcCcCcCcCcCcCcCcCaicCcCcCcCcCcCcCcCcCcCabababababababababababababcD
cDababababababababcCcCcCcCcCcCcCcCcCcCcCcCcCcCcCcCcCcCcCcCcCcCcCcCcCcCcCcCcCcCcCcCcCcCcCcCcCcCcCcCcCcCcCcCcCcCcCcCcCcCcCcCcCcCcCcCcCcCcCcCcCcCcCcCcCcCcCcCcCcCcCcCcCcCcCcCcCabababababababababababababcD
cDabababababababcCcCcCcCcCcCcCcCcCcCcCcCcCcCcCcCcCcCcCcCcCcCcCcCcCcCcCcCcCcCcCcCcCcCcCcCcCcCcCcCafcCcCcCcCcCcCcCcCcCcCcCafcCcCcCcCcCcCcCcCcCcCcCcCcCcCcCcCcCcCcCcCcCcCcCcCababababababababababababababcD
cDabababababababcCcCcCcCcCcCcCcCcCcCcCcCcCcCcCcCcCcCcCcCcCcCcCcCcCcCcCcCcCcCcCcCcCcCcCcCcCcCcCcCcCcCcCcCcCcCcCcCcCcCcCcCcCcCcCcCcCcCcCcCcCcCcCcCcCcCcCcCcCcCcCcCcCcCcCcCcCcCabababababababababababababcD
cDababababcCcCcCcCcCcCcCcCcCcCcCcCcCcCcCcCcCaecCcCcCcCaicCaicCcCcCcCcCcCcCcCcCcCcCcCcCcCcCcCcCcCaecCcCcCcCcCcCcCcCcCcCcCcCcCcCcCcCcCcCcCcCcCcCcCcCcCcCcCcCcCcCcCcCcCcCcCcCcCabababababababababababababcD
cDababababababcCcCcCcCcCaicCcCcCcCcCcCcCcCcCcCcCcCcCcCcCcCcCcCcCcCcCcCcCcCcCcCcCcCcCcCcCcCcCcCcCcCcCcCcCcCcCcCcCcCcCcCcCcCcCcCcCcCcCcCcCcCcCcCcCcCcCcCcCcCcCcCcCcCcCcCcCcCababababababababababababababcD
cDabababababababcCcCcCaicCcCcCcCcCcCcCcCcCcCcCcCcCcCcCcCcCcCcCcCcCcCcCcCcCcCcCcCcCcCcCcCcCcCcCcCcCcCcCcCcCcCcCcCcCcCcCcCcCcCcCcCcCcCcCcCcCcCcCcCcCcCcCcCcCcCcCcCcCcCabababababababababababababababababcD
cDabababababababcCcCcCcCcCcCcCcCcCcCcCcCcCcCcCcCcCcCcCcCcCcCcCcCcCcCcCcCcCcCcCcCcCcCcCcCcCcCcCcCcCcCcCcCcCcCcCcCcCcCcCcCcCaecCcCcCcCcCcCcCcCcCcCcCcCcCcCcCcCcCcCcCcCabababababababababababababababababcD
cDabababababababcCcCcCcCcCcCcCcCcCcCcCcCcCcCaicCcCcCcCcCcCcCcCcCcCcCcCcCcCcCcCcCababababcCcCcCcCcCcCcCcCcCcCcCcCcCcCcCcCcCcCcCcCcCcCcCcCcCcCcCcCcCcCcCcCcCcCcCababababababababababababababababababababcD
cDabababababababcCcCcCcCcCcCcCcCcCcCcCcCcCcCcCcCcCcCcCcCcCcCcCcCcCcCcCcCcCcCcCcCababababcCcCcCcCafcCcCcCcCcCcCcCcCcCcCcCcCcCcCcCcCcCcCcCcCcCcCcCcCababababcCabababababababababababababababababababababcD
cDabababababcCcCcCcCcCcCcCcCcCcCcCcCcCcCcCcCcCcCcCcCcCcCcCcCcCcCcCcCcCcCcCcCcCcCabababababcCcCcCcCcCcCcCcCcCcCcCcCcCcCcCcCcCcCcCcCcCcCcCcCcCcCcCabababababababababababababababababababababababababababcD
cDababababcCcCcCcCcCcCcCcCcCcCcCcCcCcCcCcCcCcCcCcCcCcCcCcCcCcCcCcCcCcCcCcCababababababababcCcCcCababcCcCcCcCcCcCcCcCcCcCcCcCaicCabcCcCcCcCcCcCcCabababababababababababababababababababababababababababcD
cDabababababababababababcCcCcCcCcCcCcCcCcCcCcCcCcCcCcCcCcCcCcCcCcCcCcCcCcCababababababababcCcCcCabababcCcCcCcCcCcCcCcCcCcCcCaicCabababcCcCcCcCababababababababababababababababababababababababababababcD
cDababababababababababababababababcCcCcCcCcCcCcCcCcCcCcCcCcCcCcCcCcCcCabababababababababababcCcCababababcCcCcCcCcCcCcCcCcCcCcCcCababababcCababababababababababababababababababababababababababababababcD
cDababababababababababababababababababababcCcCcCcCcCababababcCcCcCabababababababababababababcCababababababcCcCcCcCcCcCcCcCcCcCababababababababababababababababababababababababababababababababababababcD
cDabababababababababababababababababababababababababababababababababababababababababababababcCababababababcCcCabcCcCcCcCcCababababababababababababababababababababababababababababababababababababababcD
cDabababababababababababababababababababababababababababababababababababababababababababababababababababababababcCcCcCababababababababababababababababababababababababababababababababababababababababcD
cDababababababababababababababababababababababababababababababababababababababababababababababababababababababababababababababababababababababababababababababababababababababababababababababababababcD
cDababababababababababababababababababababababababababababababababababababababababababababababababababababababababababababababababababababababababababababababababababababababababababababababababababcD
cDababababababababababababababababababababababababababababababababababababababababababababababababababababababababababababababababababababababababababababababababababababababababababababababababababcD
cDababababababababababababababababababababababababababababababababababababababababababababababababababababababababababababababababababababababababababababababababababababababababababababababababababcD
cDcDcDcDcDcDcDcDcDcDcDcDcDcDcDcDcDcDcDcDcDcDcDcDcDcDcDcDcDcDcDcDcDcDcDcDcDcDcDcDcDcDcDcDcDcDcDcDcDcDcDcDcDcDcDcDcDcDcDcDcDcDcDcDcDcDcDcDcDcDcDcDcDcDcDcDcDcDcDcDcDcDcDcDcDcDcDcDcDcDcDcDcDcDcDcDcDcDcDcD
"}
