"aa" = (/turf/open/floor/starwars/hyperspace/p078,/area/space)
"ab" = (/turf/open/floor/starwars/hyperspace/p000,/area/space)
"ac" = (/turf/open/floor/starwars/hyperspace/p001,/area/space)
"ad" = (/turf/open/floor/starwars/hyperspace/p002,/area/space)
"ae" = (/turf/open/floor/starwars/hyperspace/p003,/area/space)
"af" = (/turf/open/floor/starwars/hyperspace/p004,/area/space)
"ag" = (/turf/open/floor/starwars/hyperspace/p005,/area/space)
"ah" = (/turf/open/floor/starwars/hyperspace/p006,/area/space)
"ai" = (/turf/open/floor/starwars/hyperspace/p007,/area/space)
"aj" = (/turf/open/floor/starwars/hyperspace/p008,/area/space)
"ak" = (/turf/open/floor/starwars/hyperspace/p009,/area/space)
"al" = (/turf/open/floor/starwars/hyperspace/p010,/area/space)
"am" = (/turf/open/floor/starwars/hyperspace/p011,/area/space)
"an" = (/turf/open/floor/starwars/hyperspace/p012,/area/space)
"ao" = (/turf/open/floor/starwars/hyperspace/p013,/area/space)
"ap" = (/turf/open/floor/starwars/hyperspace/p014,/area/space)
"aq" = (/turf/open/floor/starwars/hyperspace/p015,/area/space)
"ar" = (/turf/open/floor/starwars/hyperspace/p016,/area/space)
"as" = (/turf/open/floor/starwars/hyperspace/p017,/area/space)
"at" = (/turf/open/floor/starwars/hyperspace/p018,/area/space)
"au" = (/turf/open/floor/starwars/hyperspace/p019,/area/space)
"av" = (/turf/open/floor/starwars/hyperspace/p020,/area/space)
"aw" = (/turf/open/floor/starwars/hyperspace/p021,/area/space)
"ax" = (/turf/open/floor/starwars/hyperspace/p022,/area/space)
"ay" = (/turf/open/floor/starwars/hyperspace/p023,/area/space)
"az" = (/turf/open/floor/starwars/hyperspace/p024,/area/space)
"aA" = (/turf/open/floor/starwars/hyperspace/p025,/area/space)
"aB" = (/turf/open/floor/starwars/hyperspace/p026,/area/space)
"aC" = (/turf/open/floor/starwars/hyperspace/p027,/area/space)
"aD" = (/turf/open/floor/starwars/hyperspace/p028,/area/space)
"aE" = (/turf/open/floor/starwars/hyperspace/p029,/area/space)
"aF" = (/turf/open/floor/starwars/hyperspace/p030,/area/space)
"aG" = (/turf/open/floor/starwars/hyperspace/p031,/area/space)
"aH" = (/turf/open/floor/starwars/hyperspace/p032,/area/space)
"aI" = (/turf/open/floor/starwars/hyperspace/p033,/area/space)
"aJ" = (/turf/open/floor/starwars/hyperspace/p034,/area/space)
"aK" = (/turf/open/floor/starwars/hyperspace/p035,/area/space)
"aL" = (/turf/open/floor/starwars/hyperspace/p036,/area/space)
"aM" = (/turf/open/floor/starwars/hyperspace/p037,/area/space)
"aN" = (/turf/open/floor/starwars/hyperspace/p038,/area/space)
"aO" = (/turf/open/floor/starwars/hyperspace/p039,/area/space)
"aP" = (/turf/open/floor/starwars/hyperspace/p040,/area/space)
"aQ" = (/turf/open/floor/starwars/hyperspace/p041,/area/space)
"aR" = (/turf/open/floor/starwars/hyperspace/p042,/area/space)
"aS" = (/turf/open/floor/starwars/hyperspace/p043,/area/space)
"aT" = (/turf/open/floor/starwars/hyperspace/p044,/area/space)
"aU" = (/turf/open/floor/starwars/hyperspace/p045,/area/space)
"aV" = (/turf/open/floor/starwars/hyperspace/p046,/area/space)
"aW" = (/turf/open/floor/starwars/hyperspace/p047,/area/space)
"aX" = (/turf/open/floor/starwars/hyperspace/p048,/area/space)
"aY" = (/turf/open/floor/starwars/hyperspace/p049,/area/space)
"aZ" = (/turf/open/floor/starwars/hyperspace/p050,/area/space)
"ba" = (/turf/open/floor/starwars/hyperspace/p051,/area/space)
"bb" = (/turf/open/floor/starwars/hyperspace/p052,/area/space)
"bc" = (/turf/open/floor/starwars/hyperspace/p053,/area/space)
"bd" = (/turf/open/floor/starwars/hyperspace/p054,/area/space)
"be" = (/turf/open/floor/starwars/hyperspace/p055,/area/space)
"bf" = (/turf/open/floor/starwars/hyperspace/p056,/area/space)
"bg" = (/turf/open/floor/starwars/hyperspace/p057,/area/space)
"bh" = (/turf/open/floor/starwars/hyperspace/p058,/area/space)
"bi" = (/turf/open/floor/starwars/hyperspace/p059,/area/space)
"bj" = (/turf/open/floor/starwars/hyperspace/p060,/area/space)
"bk" = (/turf/open/floor/starwars/hyperspace/p061,/area/space)
"bl" = (/turf/open/floor/starwars/hyperspace/p062,/area/space)
"bm" = (/turf/open/floor/starwars/hyperspace/p063,/area/space)
"bn" = (/turf/open/floor/starwars/hyperspace/p064,/area/space)
"bo" = (/turf/open/floor/starwars/hyperspace/p065,/area/space)
"bp" = (/turf/open/floor/starwars/hyperspace/p066,/area/space)
"bq" = (/turf/open/floor/starwars/hyperspace/p067,/area/space)
"br" = (/turf/open/floor/starwars/hyperspace/p068,/area/space)
"bs" = (/turf/open/floor/starwars/hyperspace/p069,/area/space)
"bt" = (/turf/open/floor/starwars/hyperspace/p070,/area/space)
"bu" = (/turf/open/floor/starwars/hyperspace/p071,/area/space)
"bv" = (/turf/open/floor/starwars/hyperspace/p072,/area/space)
"bw" = (/turf/open/floor/starwars/hyperspace/p073,/area/space)
"bx" = (/turf/open/floor/starwars/hyperspace/p074,/area/space)
"by" = (/turf/open/floor/starwars/hyperspace/p075,/area/space)
"bz" = (/turf/open/floor/starwars/hyperspace/p076,/area/space)
"bA" = (/turf/open/floor/starwars/hyperspace/p077,/area/space)
"bB" = (/turf/open/floor/starwars/hyperspace/p079,/area/space)
"bC" = (/turf/open/floor/starwars/hyperspace/p080,/area/space)
"bD" = (/turf/open/floor/starwars/hyperspace/p081,/area/space)
"bE" = (/turf/open/floor/starwars/hyperspace/p082,/area/space)
"bF" = (/turf/open/floor/starwars/hyperspace/p083,/area/space)
"bG" = (/turf/open/floor/starwars/hyperspace/p084,/area/space)
"bH" = (/turf/open/floor/starwars/hyperspace/p085,/area/space)
"bI" = (/turf/open/floor/starwars/hyperspace/p086,/area/space)
"bJ" = (/turf/open/floor/starwars/hyperspace/p087,/area/space)
"bK" = (/turf/open/floor/starwars/hyperspace/p088,/area/space)
"bL" = (/turf/open/floor/starwars/hyperspace/p089,/area/space)
"bM" = (/turf/open/floor/starwars/hyperspace/p090,/area/space)
"bN" = (/turf/open/floor/starwars/hyperspace/p091,/area/space)
"bO" = (/turf/open/floor/starwars/hyperspace/p092,/area/space)
"bP" = (/turf/open/floor/starwars/hyperspace/p093,/area/space)
"bQ" = (/turf/open/floor/starwars/hyperspace/p094,/area/space)
"bR" = (/turf/open/floor/starwars/hyperspace/p095,/area/space)
"bS" = (/turf/open/floor/starwars/hyperspace/p096,/area/space)
"bT" = (/turf/open/floor/starwars/hyperspace/p097,/area/space)
"bU" = (/turf/open/floor/starwars/hyperspace/p098,/area/space)
"bV" = (/turf/open/floor/starwars/hyperspace/p099,/area/space)
"bW" = (/turf/open/floor/starwars/hyperspace/p100,/area/space)
"bX" = (/turf/open/floor/starwars/hyperspace/p101,/area/space)
"bY" = (/turf/open/floor/starwars/hyperspace/p102,/area/space)
"bZ" = (/turf/open/floor/starwars/hyperspace/p103,/area/space)
"ca" = (/turf/open/floor/starwars/hyperspace/p104,/area/space)
"cb" = (/turf/open/floor/starwars/hyperspace/p105,/area/space)
"cc" = (/turf/open/floor/starwars/hyperspace/p106,/area/space)
"cd" = (/turf/open/floor/starwars/hyperspace/p107,/area/space)
"ce" = (/turf/open/floor/starwars/hyperspace/p108,/area/space)
"cf" = (/turf/open/floor/starwars/hyperspace/p109,/area/space)
"cg" = (/turf/open/floor/starwars/hyperspace/p110,/area/space)
"ch" = (/turf/open/floor/starwars/hyperspace/p111,/area/space)
"ci" = (/turf/open/floor/starwars/hyperspace/p112,/area/space)
"cj" = (/turf/open/floor/starwars/hyperspace/p113,/area/space)
"ck" = (/turf/open/floor/starwars/hyperspace/p114,/area/space)
"cl" = (/turf/open/floor/starwars/hyperspace/p115,/area/space)
"cm" = (/turf/open/floor/starwars/hyperspace/p116,/area/space)
"cn" = (/turf/open/floor/starwars/hyperspace/p117,/area/space)
"co" = (/turf/open/floor/starwars/hyperspace/p118,/area/space)
"cp" = (/turf/open/floor/starwars/hyperspace/p119,/area/space)
"cq" = (/turf/open/floor/starwars/hyperspace/p120,/area/space)
"cr" = (/turf/open/floor/starwars/hyperspace/p121,/area/space)
"cs" = (/turf/open/floor/starwars/hyperspace/p122,/area/space)
"ct" = (/turf/open/floor/starwars/hyperspace/p123,/area/space)
"cu" = (/turf/open/floor/starwars/hyperspace/p124,/area/space)
"cv" = (/turf/open/floor/starwars/hyperspace/p125,/area/space)
"cw" = (/turf/open/floor/starwars/hyperspace/p126,/area/space)
"cx" = (/turf/open/floor/starwars/hyperspace/p127,/area/space)
"cy" = (/turf/open/floor/starwars/hyperspace/p128,/area/space)
"cz" = (/turf/open/floor/starwars/hyperspace/p129,/area/space)
"cA" = (/turf/open/floor/starwars/hyperspace/p130,/area/space)
"cB" = (/turf/open/floor/starwars/hyperspace/p131,/area/space)
"cC" = (/turf/open/floor/starwars/hyperspace/p132,/area/space)
"cD" = (/turf/open/floor/starwars/hyperspace/p133,/area/space)
"cE" = (/turf/open/floor/starwars/hyperspace/p134,/area/space)
"cF" = (/turf/open/floor/starwars/hyperspace/p135,/area/space)
"cG" = (/turf/open/floor/starwars/hyperspace/p136,/area/space)
"cH" = (/turf/open/floor/starwars/hyperspace/p137,/area/space)
"cI" = (/turf/open/floor/starwars/hyperspace/p138,/area/space)
"cJ" = (/turf/open/floor/starwars/hyperspace/p139,/area/space)
"cK" = (/turf/open/floor/starwars/hyperspace/p140,/area/space)
"cL" = (/turf/open/floor/starwars/hyperspace/p141,/area/space)
"cM" = (/turf/open/floor/starwars/hyperspace/p142,/area/space)
"cN" = (/turf/open/floor/starwars/hyperspace/p143,/area/space)
"cO" = (/turf/open/floor/starwars/hyperspace/p144,/area/space)
"cP" = (/turf/open/floor/starwars/hyperspace/p145,/area/space)
"cQ" = (/turf/open/floor/starwars/hyperspace/p146,/area/space)
"cR" = (/turf/open/floor/starwars/hyperspace/p147,/area/space)
"cS" = (/turf/open/floor/starwars/hyperspace/p148,/area/space)
"cT" = (/turf/open/floor/starwars/hyperspace/p149,/area/space)
"cU" = (/turf/open/floor/starwars/hyperspace/p150,/area/space)
"cV" = (/turf/open/floor/starwars/hyperspace/p151,/area/space)
"cW" = (/turf/open/floor/starwars/hyperspace/p152,/area/space)
"cX" = (/turf/open/floor/starwars/hyperspace/p153,/area/space)
"cY" = (/turf/open/floor/starwars/hyperspace/p154,/area/space)
"cZ" = (/turf/open/floor/starwars/hyperspace/p155,/area/space)
"da" = (/turf/open/floor/starwars/hyperspace/p156,/area/space)
"db" = (/turf/open/floor/starwars/hyperspace/p157,/area/space)
"dc" = (/turf/open/floor/starwars/hyperspace/p158,/area/space)
"dd" = (/turf/open/floor/starwars/hyperspace/p159,/area/space)
"de" = (/turf/open/floor/starwars/hyperspace/p160,/area/space)
"df" = (/turf/open/floor/starwars/hyperspace/p161,/area/space)
"dg" = (/turf/open/floor/starwars/hyperspace/p162,/area/space)
"dh" = (/turf/open/floor/starwars/hyperspace/p163,/area/space)
"di" = (/turf/open/floor/starwars/hyperspace/p164,/area/space)
"dj" = (/turf/open/floor/starwars/hyperspace/p165,/area/space)
"dk" = (/turf/open/floor/starwars/hyperspace/p166,/area/space)
"dl" = (/turf/open/floor/starwars/hyperspace/p167,/area/space)
"dm" = (/turf/open/floor/starwars/hyperspace/p168,/area/space)
"dn" = (/turf/open/floor/starwars/hyperspace/p169,/area/space)
"do" = (/turf/open/floor/starwars/hyperspace/p170,/area/space)
"dp" = (/turf/open/floor/starwars/hyperspace/p171,/area/space)
"dq" = (/turf/open/floor/starwars/hyperspace/p172,/area/space)
"dr" = (/turf/open/floor/starwars/hyperspace/p173,/area/space)
"ds" = (/turf/open/floor/starwars/hyperspace/p174,/area/space)
"dt" = (/turf/open/floor/starwars/hyperspace/p175,/area/space)
"du" = (/turf/open/floor/starwars/hyperspace/p176,/area/space)
"dv" = (/turf/open/floor/starwars/hyperspace/p177,/area/space)
"dw" = (/turf/open/floor/starwars/hyperspace/p178,/area/space)
"dx" = (/turf/open/floor/starwars/hyperspace/p179,/area/space)
"dy" = (/turf/open/floor/starwars/hyperspace/p180,/area/space)
"dz" = (/turf/open/floor/starwars/hyperspace/p181,/area/space)
"dA" = (/turf/open/floor/starwars/hyperspace/p182,/area/space)
"dB" = (/turf/open/floor/starwars/hyperspace/p183,/area/space)
"dC" = (/turf/open/floor/starwars/hyperspace/p184,/area/space)
"dD" = (/turf/open/floor/starwars/hyperspace/p185,/area/space)
"dE" = (/turf/open/floor/starwars/hyperspace/p186,/area/space)
"dF" = (/turf/open/floor/starwars/hyperspace/p187,/area/space)
"dG" = (/turf/open/floor/starwars/hyperspace/p188,/area/space)
"dH" = (/turf/open/floor/starwars/hyperspace/p189,/area/space)
"dI" = (/turf/open/floor/starwars/hyperspace/p190,/area/space)
"dJ" = (/turf/open/floor/starwars/hyperspace/p191,/area/space)
"dK" = (/turf/open/floor/starwars/hyperspace/p192,/area/space)
"dL" = (/turf/open/floor/starwars/hyperspace/p193,/area/space)
"dM" = (/turf/open/floor/starwars/hyperspace/p194,/area/space)
"dN" = (/turf/open/floor/starwars/hyperspace/p195,/area/space)
"dO" = (/turf/open/floor/starwars/hyperspace/p196,/area/space)
"dP" = (/turf/open/floor/starwars/hyperspace/p197,/area/space)
"dQ" = (/turf/open/floor/starwars/hyperspace/p198,/area/space)
"dR" = (/turf/open/floor/starwars/hyperspace/p199,/area/space)
"dS" = (/turf/open/floor/starwars/hyperspace/p200,/area/space)
"dT" = (/turf/open/floor/starwars/hyperspace/p201,/area/space)
"dU" = (/turf/open/floor/starwars/hyperspace/p202,/area/space)
"dV" = (/turf/open/floor/starwars/hyperspace/p203,/area/space)
"dW" = (/turf/open/floor/starwars/hyperspace/p204,/area/space)
"dX" = (/turf/open/floor/starwars/hyperspace/p205,/area/space)
"dY" = (/turf/open/floor/starwars/hyperspace/p206,/area/space)
"dZ" = (/turf/open/floor/starwars/hyperspace/p207,/area/space)
"ea" = (/turf/open/floor/starwars/hyperspace/p208,/area/space/hyperspace)
"eb" = (/turf/open/floor/starwars/hyperspace/p209,/area/space/hyperspace)
"ec" = (/turf/open/floor/starwars/hyperspace/p210,/area/space/hyperspace)
"ed" = (/turf/open/floor/starwars/hyperspace/p211,/area/space/hyperspace)
"ee" = (/turf/open/floor/starwars/hyperspace/p212,/area/space)
"ef" = (/turf/open/floor/starwars/hyperspace/p213,/area/space)
"eg" = (/turf/open/floor/starwars/hyperspace/p214,/area/space)
"eh" = (/turf/open/floor/starwars/hyperspace/p215,/area/space)
"ei" = (/turf/open/floor/starwars/hyperspace/p216,/area/space)
"ej" = (/turf/open/floor/starwars/hyperspace/p217,/area/space)
"ek" = (/turf/open/floor/starwars/hyperspace/p218,/area/space)
"el" = (/turf/open/floor/starwars/hyperspace/p219,/area/space)
"em" = (/turf/open/floor/starwars/hyperspace/p220,/area/space)
"en" = (/turf/open/floor/starwars/hyperspace/p221,/area/space)
"eo" = (/turf/open/floor/starwars/hyperspace/p222,/area/space)
"ep" = (/turf/open/floor/starwars/hyperspace/p223,/area/space)
"eq" = (/turf/open/floor/starwars/hyperspace/p224,/area/space)
"er" = (/turf/open/floor/starwars/hyperspace/p225,/area/space)
"es" = (/turf/open/floor/starwars/hyperspace/p226,/area/space)
"et" = (/turf/open/floor/starwars/hyperspace/p227,/area/space)
"eu" = (/turf/open/floor/starwars/hyperspace/p228,/area/space/hyperspace)
"ev" = (/turf/open/floor/starwars/hyperspace/p229,/area/space/hyperspace)
"ew" = (/turf/open/floor/starwars/hyperspace/p230,/area/space/hyperspace)
"ex" = (/turf/open/floor/starwars/hyperspace/p231,/area/space/hyperspace)
"ey" = (/turf/open/floor/starwars/hyperspace/p232,/area/space)
"ez" = (/turf/open/floor/starwars/hyperspace/p233,/area/space)
"eA" = (/turf/open/floor/starwars/hyperspace/p234,/area/space)
"eB" = (/turf/open/floor/starwars/hyperspace/p235,/area/space)
"eC" = (/turf/open/floor/starwars/hyperspace/p236,/area/space)
"eD" = (/turf/open/floor/starwars/hyperspace/p237,/area/space)
"eE" = (/turf/open/floor/starwars/hyperspace/p238,/area/space)
"eF" = (/turf/open/floor/starwars/hyperspace/p239,/area/space)
"eG" = (/turf/open/floor/starwars/hyperspace/p240,/area/space)
"eH" = (/turf/open/floor/starwars/hyperspace/p241,/area/space)
"eI" = (/turf/open/floor/starwars/hyperspace/p242,/area/space)
"eJ" = (/turf/open/floor/starwars/hyperspace/p243,/area/space)
"eK" = (/turf/open/floor/starwars/hyperspace/p244,/area/space)
"eL" = (/turf/open/floor/starwars/hyperspace/p245,/area/space)
"eM" = (/turf/open/floor/starwars/hyperspace/p246,/area/space)
"eN" = (/turf/open/floor/starwars/hyperspace/p247,/area/space)
"eO" = (/turf/open/floor/starwars/hyperspace/p248,/area/space/hyperspace)
"eP" = (/turf/open/floor/starwars/hyperspace/p249,/area/space/hyperspace)
"eQ" = (/turf/open/floor/starwars/hyperspace/p250,/area/space/hyperspace)
"eR" = (/turf/open/floor/starwars/hyperspace/p251,/area/space/hyperspace)
"eS" = (/turf/open/floor/starwars/hyperspace/p252,/area/space)
"eT" = (/turf/open/floor/starwars/hyperspace/p253,/area/space)
"eU" = (/turf/open/floor/starwars/hyperspace/p254,/area/space)
"eV" = (/turf/open/floor/starwars/hyperspace/p255,/area/space)
"eW" = (/turf/open/floor/starwars/hyperspace/p256,/area/space)
"eX" = (/turf/open/floor/starwars/hyperspace/p257,/area/space)
"eY" = (/turf/open/floor/starwars/hyperspace/p258,/area/space)
"eZ" = (/turf/open/floor/starwars/hyperspace/p259,/area/space)
"fa" = (/turf/open/floor/starwars/hyperspace/p260,/area/space)
"fb" = (/turf/open/floor/starwars/hyperspace/p261,/area/space)
"fc" = (/turf/open/floor/starwars/hyperspace/p262,/area/space)
"fd" = (/turf/open/floor/starwars/hyperspace/p263,/area/space)
"fe" = (/turf/open/floor/starwars/hyperspace/p264,/area/space)
"ff" = (/turf/open/floor/starwars/hyperspace/p265,/area/space)
"fg" = (/turf/open/floor/starwars/hyperspace/p266,/area/space)
"fh" = (/turf/open/floor/starwars/hyperspace/p267,/area/space)
"fi" = (/turf/open/floor/starwars/hyperspace/p268,/area/space)
"fj" = (/turf/open/floor/starwars/hyperspace/p269,/area/space)
"fk" = (/turf/open/floor/starwars/hyperspace/p270,/area/space)
"fl" = (/turf/open/floor/starwars/hyperspace/p271,/area/space)
"fm" = (/turf/open/floor/starwars/hyperspace/p272,/area/space)
"fn" = (/turf/open/floor/starwars/hyperspace/p273,/area/space)
"fo" = (/turf/open/floor/starwars/hyperspace/p274,/area/space)
"fp" = (/turf/open/floor/starwars/hyperspace/p275,/area/space)
"fq" = (/turf/open/floor/starwars/hyperspace/p276,/area/space)
"fr" = (/turf/open/floor/starwars/hyperspace/p277,/area/space)
"fs" = (/turf/open/floor/starwars/hyperspace/p278,/area/space)
"ft" = (/turf/open/floor/starwars/hyperspace/p279,/area/space)
"fu" = (/turf/open/floor/starwars/hyperspace/p280,/area/space)
"fv" = (/turf/open/floor/starwars/hyperspace/p281,/area/space)
"fw" = (/turf/open/floor/starwars/hyperspace/p282,/area/space)
"fx" = (/turf/open/floor/starwars/hyperspace/p283,/area/space)
"fy" = (/turf/open/floor/starwars/hyperspace/p284,/area/space)
"fz" = (/turf/open/floor/starwars/hyperspace/p285,/area/space)
"fA" = (/turf/open/floor/starwars/hyperspace/p286,/area/space)
"fB" = (/turf/open/floor/starwars/hyperspace/p287,/area/space)
"fC" = (/turf/open/floor/starwars/hyperspace/p288,/area/space)
"fD" = (/turf/open/floor/starwars/hyperspace/p289,/area/space)
"fE" = (/turf/open/floor/starwars/hyperspace/p290,/area/space)
"fF" = (/turf/open/floor/starwars/hyperspace/p291,/area/space)
"fG" = (/turf/open/floor/starwars/hyperspace/p292,/area/space)
"fH" = (/turf/open/floor/starwars/hyperspace/p293,/area/space)
"fI" = (/turf/open/floor/starwars/hyperspace/p294,/area/space)
"fJ" = (/turf/open/floor/starwars/hyperspace/p295,/area/space)
"fK" = (/turf/open/floor/starwars/hyperspace/p296,/area/space)
"fL" = (/turf/open/floor/starwars/hyperspace/p297,/area/space)
"fM" = (/turf/open/floor/starwars/hyperspace/p298,/area/space)
"fN" = (/turf/open/floor/starwars/hyperspace/p299,/area/space)
"fO" = (/turf/open/floor/starwars/hyperspace/p300,/area/space)
"fP" = (/turf/open/floor/starwars/hyperspace/p301,/area/space)
"fQ" = (/turf/open/floor/starwars/hyperspace/p302,/area/space)
"fR" = (/turf/open/floor/starwars/hyperspace/p303,/area/space)
"fS" = (/turf/open/floor/starwars/hyperspace/p304,/area/space)
"fT" = (/turf/open/floor/starwars/hyperspace/p305,/area/space)
"fU" = (/turf/open/floor/starwars/hyperspace/p306,/area/space)
"fV" = (/turf/open/floor/starwars/hyperspace/p307,/area/space)
"fW" = (/turf/open/floor/starwars/hyperspace/p308,/area/space)
"fX" = (/turf/open/floor/starwars/hyperspace/p309,/area/space)
"fY" = (/turf/open/floor/starwars/hyperspace/p310,/area/space)
"fZ" = (/turf/open/floor/starwars/hyperspace/p311,/area/space)
"ga" = (/turf/open/floor/starwars/hyperspace/p312,/area/space)
"gb" = (/turf/open/floor/starwars/hyperspace/p313,/area/space)
"gc" = (/turf/open/floor/starwars/hyperspace/p314,/area/space)
"gd" = (/turf/open/floor/starwars/hyperspace/p315,/area/space)
"ge" = (/turf/open/floor/starwars/hyperspace/p316,/area/space)
"gf" = (/turf/open/floor/starwars/hyperspace/p317,/area/space)
"gg" = (/turf/open/floor/starwars/hyperspace/p318,/area/space)
"gh" = (/turf/open/floor/starwars/hyperspace/p319,/area/space)
"gi" = (/turf/open/floor/starwars/hyperspace/p320,/area/space)
"gj" = (/turf/open/floor/starwars/hyperspace/p321,/area/space)
"gk" = (/turf/open/floor/starwars/hyperspace/p322,/area/space)
"gl" = (/turf/open/floor/starwars/hyperspace/p323,/area/space)
"gm" = (/turf/open/floor/starwars/hyperspace/p324,/area/space)
"gn" = (/turf/open/floor/starwars/hyperspace/p325,/area/space)
"go" = (/turf/open/floor/starwars/hyperspace/p326,/area/space)
"gp" = (/turf/open/floor/starwars/hyperspace/p327,/area/space)
"gq" = (/turf/open/floor/starwars/hyperspace/p328,/area/space)
"gr" = (/turf/open/floor/starwars/hyperspace/p329,/area/space)
"gs" = (/turf/open/floor/starwars/hyperspace/p330,/area/space)
"gt" = (/turf/open/floor/starwars/hyperspace/p331,/area/space)
"gu" = (/turf/open/floor/starwars/hyperspace/p332,/area/space)
"gv" = (/turf/open/floor/starwars/hyperspace/p333,/area/space)
"gw" = (/turf/open/floor/starwars/hyperspace/p334,/area/space)
"gx" = (/turf/open/floor/starwars/hyperspace/p335,/area/space)
"gy" = (/turf/open/floor/starwars/hyperspace/p336,/area/space)
"gz" = (/turf/open/floor/starwars/hyperspace/p337,/area/space)
"gA" = (/turf/open/floor/starwars/hyperspace/p338,/area/space)
"gB" = (/turf/open/floor/starwars/hyperspace/p339,/area/space)
"gC" = (/turf/open/floor/starwars/hyperspace/p340,/area/space)
"gD" = (/turf/open/floor/starwars/hyperspace/p341,/area/space)
"gE" = (/turf/open/floor/starwars/hyperspace/p342,/area/space)
"gF" = (/turf/open/floor/starwars/hyperspace/p343,/area/space)
"gG" = (/turf/open/floor/starwars/hyperspace/p344,/area/space)
"gH" = (/turf/open/floor/starwars/hyperspace/p345,/area/space)
"gI" = (/turf/open/floor/starwars/hyperspace/p346,/area/space)
"gJ" = (/turf/open/floor/starwars/hyperspace/p347,/area/space)
"gK" = (/turf/open/floor/starwars/hyperspace/p348,/area/space)
"gL" = (/turf/open/floor/starwars/hyperspace/p349,/area/space)
"gM" = (/turf/open/floor/starwars/hyperspace/p350,/area/space)
"gN" = (/turf/open/floor/starwars/hyperspace/p351,/area/space)
"gO" = (/turf/open/floor/starwars/hyperspace/p352,/area/space)
"gP" = (/turf/open/floor/starwars/hyperspace/p353,/area/space)
"gQ" = (/turf/open/floor/starwars/hyperspace/p354,/area/space)
"gR" = (/turf/open/floor/starwars/hyperspace/p355,/area/space)
"gS" = (/turf/open/floor/starwars/hyperspace/p356,/area/space)
"gT" = (/turf/open/floor/starwars/hyperspace/p357,/area/space)
"gU" = (/turf/open/floor/starwars/hyperspace/p358,/area/space)
"gV" = (/turf/open/floor/starwars/hyperspace/p359,/area/space)
"gW" = (/turf/open/floor/starwars/hyperspace/p360,/area/space)
"gX" = (/turf/open/floor/starwars/hyperspace/p361,/area/space)
"gY" = (/turf/open/floor/starwars/hyperspace/p362,/area/space)
"gZ" = (/turf/open/floor/starwars/hyperspace/p363,/area/space)
"ha" = (/turf/open/floor/starwars/hyperspace/p364,/area/space)
"hb" = (/turf/open/floor/starwars/hyperspace/p365,/area/space)
"hc" = (/turf/open/floor/starwars/hyperspace/p366,/area/space)
"hd" = (/turf/open/floor/starwars/hyperspace/p367,/area/space)
"he" = (/turf/open/floor/starwars/hyperspace/p368,/area/space)
"hf" = (/turf/open/floor/starwars/hyperspace/p369,/area/space)
"hg" = (/turf/open/floor/starwars/hyperspace/p370,/area/space)
"hh" = (/turf/open/floor/starwars/hyperspace/p371,/area/space)
"hi" = (/turf/open/floor/starwars/hyperspace/p372,/area/space)
"hj" = (/turf/open/floor/starwars/hyperspace/p373,/area/space)
"hk" = (/turf/open/floor/starwars/hyperspace/p374,/area/space)
"hl" = (/turf/open/floor/starwars/hyperspace/p375,/area/space)
"hm" = (/turf/open/floor/starwars/hyperspace/p376,/area/space)
"hn" = (/turf/open/floor/starwars/hyperspace/p377,/area/space)
"ho" = (/turf/open/floor/starwars/hyperspace/p378,/area/space)
"hp" = (/turf/open/floor/starwars/hyperspace/p379,/area/space)
"hq" = (/turf/open/floor/starwars/hyperspace/p380,/area/space)
"hr" = (/turf/open/floor/starwars/hyperspace/p381,/area/space)
"hs" = (/turf/open/floor/starwars/hyperspace/p382,/area/space)
"ht" = (/turf/open/floor/starwars/hyperspace/p383,/area/space)
"hu" = (/turf/open/floor/starwars/hyperspace/p384,/area/space)
"hv" = (/turf/open/floor/starwars/hyperspace/p385,/area/space)
"hw" = (/turf/open/floor/starwars/hyperspace/p386,/area/space)
"hx" = (/turf/open/floor/starwars/hyperspace/p387,/area/space)
"hy" = (/turf/open/floor/starwars/hyperspace/p388,/area/space)
"hz" = (/turf/open/floor/starwars/hyperspace/p389,/area/space)
"hA" = (/turf/open/floor/starwars/hyperspace/p390,/area/space)
"hB" = (/turf/open/floor/starwars/hyperspace/p391,/area/space)
"hC" = (/turf/open/floor/starwars/hyperspace/p392,/area/space)
"hD" = (/turf/open/floor/starwars/hyperspace/p393,/area/space)
"hE" = (/turf/open/floor/starwars/hyperspace/p394,/area/space)
"hF" = (/turf/open/floor/starwars/hyperspace/p395,/area/space)
"hG" = (/turf/open/floor/starwars/hyperspace/p396,/area/space)
"hH" = (/turf/open/floor/starwars/hyperspace/p397,/area/space)
"hI" = (/turf/open/floor/starwars/hyperspace/p398,/area/space)
"hJ" = (/turf/open/floor/starwars/hyperspace/p399,/area/space)
"hK" = (/turf/closed/wall/hyperspace,/area/space)

(1,1,1) = {"
hKhKhKhKhKhKhKhKhKhKhKhKhKhKhKhKhKhKhKhKhKhK
hKabacadaeafagahaiajakalamanaoapaqarasatauhK
hKavawaxayazaAaBaCaDaEaFaGaHaIaJaKaLaMaNaOhK
hKaPaQaRaSaTaUaVaWaXaYaZbabbbcbdbebfbgbhbihK
hKbjbkblbmbnbobpbqbrbsbtbubvbwbxbybzbAaabBhK
hKbCbDbEbFbGbHbIbJbKbLbMbNbObPbQbRbSbTbUbVhK
hKbWbXbYbZcacbcccdcecfcgchcicjckclcmcncocphK
hKcqcrcsctcucvcwcxcyczcAcBcCcDcEcFcGcHcIcJhK
hKcKcLcMcNcOcPcQcRcScTcUcVcWcXcYcZdadbdcddhK
hKdedfdgdhdidjdkdldmdndodpdqdrdsdtdudvdwdxhK
hKdydzdAdBdCdDdEdFdGdHdIdJdKdLdMdNdOdPdQdRhK
hKdSdTdUdVdWdXdYdZeaebecedeeefegeheiejekelhK
hKemeneoepeqereseteuevewexeyezeAeBeCeDeEeFhK
hKeGeHeIeJeKeLeMeNeOePeQeReSeTeUeVeWeXeYeZhK
hKfafbfcfdfefffgfhfifjfkflfmfnfofpfqfrfsfthK
hKfufvfwfxfyfzfAfBfCfDfEfFfGfHfIfJfKfLfMfNhK
hKfOfPfQfRfSfTfUfVfWfXfYfZgagbgcgdgegfggghhK
hKgigjgkglgmgngogpgqgrgsgtgugvgwgxgygzgAgBhK
hKgCgDgEgFgGgHgIgJgKgLgMgNgOgPgQgRgSgTgUgVhK
hKgWgXgYgZhahbhchdhehfhghhhihjhkhlhmhnhohphK
hKhqhrhshthuhvhwhxhyhzhAhBhChDhEhFhGhHhIhJhK
hKhKhKhKhKhKhKhKhKhKhKhKhKhKhKhKhKhKhKhKhKhK
"}
