"aa" = (/turf/open/floor/starwars/hyperspace/p078,/area/space)
"ab" = (/turf/open/floor/starwars/hyperspace/p000,/area/space)
"ac" = (/turf/open/floor/starwars/hyperspace/p001,/area/space)
"ad" = (/turf/open/floor/starwars/hyperspace/p002,/area/space)
"ae" = (/turf/open/floor/starwars/hyperspace/p003,/area/space)
"af" = (/turf/open/floor/starwars/hyperspace/p004,/area/space)
"ag" = (/turf/open/floor/starwars/hyperspace/p005,/area/space)
"ah" = (/turf/open/floor/starwars/hyperspace/p006,/area/space)
"ai" = (/turf/open/floor/starwars/hyperspace/p007,/area/space)
"aj" = (/turf/open/floor/starwars/hyperspace/p008,/area/space)
"ak" = (/turf/open/floor/starwars/hyperspace/p009,/area/space)
"al" = (/turf/open/floor/starwars/hyperspace/p010,/area/space)
"am" = (/turf/open/floor/starwars/hyperspace/p011,/area/space)
"an" = (/turf/open/floor/starwars/hyperspace/p012,/area/space)
"ao" = (/turf/open/floor/starwars/hyperspace/p013,/area/space)
"ap" = (/turf/open/floor/starwars/hyperspace/p014,/area/space)
"aq" = (/turf/open/floor/starwars/hyperspace/p015,/area/space)
"ar" = (/turf/open/floor/starwars/hyperspace/p016,/area/space)
"as" = (/turf/open/floor/starwars/hyperspace/p017,/area/space)
"at" = (/turf/open/floor/starwars/hyperspace/p018,/area/space)
"au" = (/turf/open/floor/starwars/hyperspace/p019,/area/space)
"av" = (/turf/open/floor/starwars/hyperspace/p020,/area/space)
"aw" = (/turf/open/floor/starwars/hyperspace/p021,/area/space)
"ax" = (/turf/open/floor/starwars/hyperspace/p022,/area/space)
"ay" = (/turf/open/floor/starwars/hyperspace/p023,/area/space)
"az" = (/turf/open/floor/starwars/hyperspace/p024,/area/space)
"aA" = (/turf/open/floor/starwars/hyperspace/p025,/area/space)
"aB" = (/turf/open/floor/starwars/hyperspace/p026,/area/space)
"aC" = (/turf/open/floor/starwars/hyperspace/p027,/area/space)
"aD" = (/turf/open/floor/starwars/hyperspace/p028,/area/space)
"aE" = (/turf/open/floor/starwars/hyperspace/p029,/area/space)
"aF" = (/turf/open/floor/starwars/hyperspace/p030,/area/space)
"aG" = (/turf/open/floor/starwars/hyperspace/p031,/area/space)
"aH" = (/turf/open/floor/starwars/hyperspace/p032,/area/space)
"aI" = (/turf/open/floor/starwars/hyperspace/p033,/area/space)
"aJ" = (/turf/open/floor/starwars/hyperspace/p034,/area/space)
"aK" = (/turf/open/floor/starwars/hyperspace/p035,/area/space)
"aL" = (/turf/open/floor/starwars/hyperspace/p036,/area/space)
"aM" = (/turf/open/floor/starwars/hyperspace/p037,/area/space)
"aN" = (/turf/open/floor/starwars/hyperspace/p038,/area/space)
"aO" = (/turf/open/floor/starwars/hyperspace/p039,/area/space)
"aP" = (/turf/open/floor/starwars/hyperspace/p040,/area/space)
"aQ" = (/turf/open/floor/starwars/hyperspace/p041,/area/space)
"aR" = (/turf/open/floor/starwars/hyperspace/p042,/area/space)
"aS" = (/turf/open/floor/starwars/hyperspace/p043,/area/space)
"aT" = (/turf/open/floor/starwars/hyperspace/p044,/area/space)
"aU" = (/turf/open/floor/starwars/hyperspace/p045,/area/space)
"aV" = (/turf/open/floor/starwars/hyperspace/p046,/area/space)
"aW" = (/turf/open/floor/starwars/hyperspace/p047,/area/space)
"aX" = (/turf/open/floor/starwars/hyperspace/p048,/area/space)
"aY" = (/turf/open/floor/starwars/hyperspace/p049,/area/space)
"aZ" = (/turf/open/floor/starwars/hyperspace/p050,/area/space)
"ba" = (/turf/open/floor/starwars/hyperspace/p051,/area/space)
"bb" = (/turf/open/floor/starwars/hyperspace/p052,/area/space)
"bc" = (/turf/open/floor/starwars/hyperspace/p053,/area/space)
"bd" = (/turf/open/floor/starwars/hyperspace/p054,/area/space)
"be" = (/turf/open/floor/starwars/hyperspace/p055,/area/space)
"bf" = (/turf/open/floor/starwars/hyperspace/p056,/area/space)
"bg" = (/turf/open/floor/starwars/hyperspace/p057,/area/space)
"bh" = (/turf/open/floor/starwars/hyperspace/p058,/area/space)
"bi" = (/turf/open/floor/starwars/hyperspace/p059,/area/space)
"bj" = (/turf/open/floor/starwars/hyperspace/p060,/area/space)
"bk" = (/turf/open/floor/starwars/hyperspace/p061,/area/space)
"bl" = (/turf/open/floor/starwars/hyperspace/p062,/area/space)
"bm" = (/turf/open/floor/starwars/hyperspace/p063,/area/space)
"bn" = (/turf/open/floor/starwars/hyperspace/p064,/area/space)
"bo" = (/turf/open/floor/starwars/hyperspace/p065,/area/space)
"bp" = (/turf/open/floor/starwars/hyperspace/p066,/area/space)
"bq" = (/turf/open/floor/starwars/hyperspace/p067,/area/space)
"br" = (/turf/open/floor/starwars/hyperspace/p068,/area/space)
"bs" = (/turf/open/floor/starwars/hyperspace/p069,/area/space)
"bt" = (/turf/open/floor/starwars/hyperspace/p070,/area/space)
"bu" = (/turf/open/floor/starwars/hyperspace/p071,/area/space)
"bv" = (/turf/open/floor/starwars/hyperspace/p072,/area/space)
"bw" = (/turf/open/floor/starwars/hyperspace/p073,/area/space)
"bx" = (/turf/open/floor/starwars/hyperspace/p074,/area/space)
"by" = (/turf/open/floor/starwars/hyperspace/p075,/area/space)
"bz" = (/turf/open/floor/starwars/hyperspace/p076,/area/space)
"bA" = (/turf/open/floor/starwars/hyperspace/p077,/area/space)
"bB" = (/turf/open/floor/starwars/hyperspace/p079,/area/space)
"bC" = (/turf/open/floor/starwars/hyperspace/p080,/area/space)

(1,1,1) = {"
abacadaeafagahaiajakalamanaoapaqarasatau
avawaxayazaAaBaCaDaEaFaGaHaIaJaKaLaMaNaO
aPaQaRaSaTaUaVaWaXaYaZbabbbcbdbebfbgbhbi
bjbkblbmbnbobpbqbrbsbtbubvbwbxbybzbAaabB
bCbCbCbCbCbCbCbCbCbCbCbCbCbCbCbCbCbCbCbC
bCbCbCbCbCbCbCbCbCbCbCbCbCbCbCbCbCbCbCbC
bCbCbCbCbCbCbCbCbCbCbCbCbCbCbCbCbCbCbCbC
bCbCbCbCbCbCbCbCbCbCbCbCbCbCbCbCbCbCbCbC
bCbCbCbCbCbCbCbCbCbCbCbCbCbCbCbCbCbCbCbC
bCbCbCbCbCbCbCbCbCbCbCbCbCbCbCbCbCbCbCbC
bCbCbCbCbCbCbCbCbCbCbCbCbCbCbCbCbCbCbCbC
bCbCbCbCbCbCbCbCbCbCbCbCbCbCbCbCbCbCbCbC
bCbCbCbCbCbCbCbCbCbCbCbCbCbCbCbCbCbCbCbC
bCbCbCbCbCbCbCbCbCbCbCbCbCbCbCbCbCbCbCbC
bCbCbCbCbCbCbCbCbCbCbCbCbCbCbCbCbCbCbCbC
bCbCbCbCbCbCbCbCbCbCbCbCbCbCbCbCbCbCbCbC
bCbCbCbCbCbCbCbCbCbCbCbCbCbCbCbCbCbCbCbC
bCbCbCbCbCbCbCbCbCbCbCbCbCbCbCbCbCbCbCbC
bCbCbCbCbCbCbCbCbCbCbCbCbCbCbCbCbCbCbCbC
bCbCbCbCbCbCbCbCbCbCbCbCbCbCbCbCbCbCbCbC
"}
