"a" = (/turf/template_noop,/area/template_noop)
"b" = (/turf/closed/wall/mineral/titanium,/area/shuttle/rebels)
"c" = (/obj/effect/spawner/structure/window/shuttle,/turf/open/floor/plating,/area/shuttle/rebels)
"d" = (/obj/machinery/light{icon_state = "tube"; dir = 4},/turf/closed/wall/mineral/titanium,/area/shuttle/rebels)
"e" = (/obj/structure/closet/emcloset,/turf/open/floor/mineral/titanium/blue,/area/shuttle/rebels)
"f" = (/obj/structure/window/reinforced{icon_state = "rwindow"; dir = 4},/obj/structure/closet/emcloset,/obj/machinery/light{dir = 1},/turf/open/floor/mineral/titanium/blue,/area/shuttle/rebels)
"g" = (/obj/structure/chair/comfy/shuttle,/obj/effect/landmark/start/imperial/acolyte,/obj/effect/landmark/start/imperial/engineer_corporal,/turf/open/floor/mineral/titanium/blue,/area/shuttle/rebels)
"h" = (/obj/structure/chair/comfy/shuttle,/obj/effect/landmark/start/imperial/asergeant,/obj/effect/landmark/start/imperial/engineer_private,/turf/open/floor/mineral/titanium/blue,/area/shuttle/rebels)
"i" = (/obj/structure/chair/comfy/shuttle,/obj/effect/landmark/start/imperial/atrooper,/obj/effect/landmark/start/imperial/engineer_sergeant,/turf/open/floor/mineral/titanium/blue,/area/shuttle/rebels)
"j" = (/obj/structure/chair/comfy/shuttle,/obj/effect/landmark/start/imperial/bsergeant,/obj/effect/landmark/start/imperial/head_surgeon,/turf/open/floor/mineral/titanium/blue,/area/shuttle/rebels)
"k" = (/obj/machinery/requests_console{department = "Arrival shuttle"; name = "Arrivals Shuttle console"; pixel_y = 30},/obj/machinery/light{dir = 1},/obj/structure/chair/comfy/shuttle,/obj/effect/landmark/start/imperial/btrooper,/obj/effect/landmark/start/imperial/imperial_medic,/turf/open/floor/mineral/titanium/blue,/area/shuttle/rebels)
"l" = (/obj/structure/window/reinforced{dir = 8},/obj/effect/turf_decal/bot,/turf/open/floor/mineral/titanium,/area/shuttle/rebels)
"m" = (/obj/structure/shuttle/engine/heater{dir = 4},/obj/structure/window/reinforced{dir = 8},/turf/open/floor/plating/airless,/area/shuttle/rebels)
"n" = (/obj/structure/shuttle/engine/propulsion/burst/right{dir = 4},/turf/open/floor/plating/airless,/area/shuttle/rebels)
"o" = (/obj/structure/table,/turf/open/floor/mineral/titanium,/area/shuttle/rebels)
"p" = (/turf/open/floor/mineral/titanium,/area/shuttle/rebels)
"q" = (/obj/machinery/door/airlock/titanium{name = "Arrivals Shuttle Airlock"},/turf/open/floor/mineral/titanium,/area/shuttle/rebels)
"r" = (/turf/open/floor/mineral/titanium/blue,/area/shuttle/rebels)
"s" = (/obj/docking_port/mobile/arrivals,/turf/open/floor/mineral/titanium,/area/shuttle/rebels)
"t" = (/obj/machinery/light/small{dir = 4},/obj/structure/chair/comfy/shuttle{dir = 8},/obj/effect/landmark/start/imperial,/obj/effect/landmark/start/imperial/emperor,/turf/open/floor/mineral/titanium,/area/shuttle/rebels)
"u" = (/obj/machinery/door/airlock/glass_large/secure/east,/obj/effect/mapping_helpers/airlock/cyclelink_helper{dir = 4},/turf/open/floor/mineral/titanium,/area/shuttle/rebels)
"v" = (/obj/structure/table,/obj/item/storage/firstaid/regular,/turf/open/floor/mineral/titanium/blue,/area/shuttle/rebels)
"w" = (/obj/structure/window/reinforced{icon_state = "rwindow"; dir = 4},/obj/structure/table,/obj/item/storage/firstaid/regular,/obj/machinery/light,/turf/open/floor/mineral/titanium/blue,/area/shuttle/rebels)
"x" = (/obj/structure/chair/comfy/shuttle{dir = 1},/obj/effect/landmark/start/imperial/cao,/obj/effect/landmark/start/imperial/crewman,/obj/effect/landmark/start/imperial/sith,/turf/open/floor/mineral/titanium/blue,/area/shuttle/rebels)
"y" = (/obj/structure/chair/comfy/shuttle{dir = 1},/obj/effect/landmark/start/imperial/captain,/obj/effect/landmark/start/imperial/storm_surgeon,/turf/open/floor/mineral/titanium/blue,/area/shuttle/rebels)
"z" = (/obj/structure/chair/comfy/shuttle{dir = 1},/obj/effect/landmark/start/imperial/clerk,/obj/effect/landmark/start/imperial/req_off,/turf/open/floor/mineral/titanium/blue,/area/shuttle/rebels)
"A" = (/obj/structure/chair/comfy/shuttle{dir = 1},/obj/effect/landmark/start/imperial/cmo,/obj/effect/landmark/start/imperial/lieutenant,/obj/effect/landmark/start/imperial/tie_pilot,/turf/open/floor/mineral/titanium/blue,/area/shuttle/rebels)
"B" = (/obj/item/radio/intercom{name = "Station Intercom (General)"; pixel_y = -29},/obj/machinery/light,/obj/structure/chair/comfy/shuttle{dir = 1},/obj/effect/landmark/start/imperial/cotg,/obj/effect/landmark/start/imperial/navy_guard,/turf/open/floor/mineral/titanium/blue,/area/shuttle/rebels)
"C" = (/obj/structure/shuttle/engine/propulsion/burst/left{dir = 4},/turf/open/floor/plating/airless,/area/shuttle/rebels)

(1,1,1) = {"
aaabbbbccccbbbd
bbbbbefghijklmn
copqrrpppppppps
cptbrrppppppppu
bbbbbvwxyzABlmC
aaabbbbccccbbbd
"}
