"a" = (/turf/template_noop,/area/template_noop)
"b" = (/turf/closed/wall/mineral/titanium,/area/shuttle/rebels)
"c" = (/obj/machinery/door/airlock/titanium{name = "Arrivals Shuttle Airlock"},/turf/open/floor/plating,/area/shuttle/rebels)
"d" = (/obj/effect/spawner/structure/window/shuttle,/turf/open/floor/plating,/area/shuttle/rebels)
"e" = (/obj/structure/table,/obj/item/storage/firstaid/regular,/turf/open/floor/mineral/titanium/blue,/area/shuttle/rebels)
"f" = (/turf/open/floor/mineral/titanium/blue,/area/shuttle/rebels)
"g" = (/obj/machinery/computer/arcade,/obj/machinery/light{dir = 1},/turf/open/floor/mineral/titanium/blue,/area/shuttle/rebels)
"h" = (/obj/structure/closet/wardrobe/green,/turf/open/floor/mineral/titanium/blue,/area/shuttle/rebels)
"i" = (/obj/structure/closet/wardrobe/black,/turf/open/floor/mineral/titanium/blue,/area/shuttle/rebels)
"j" = (/obj/structure/closet/wardrobe/mixed,/turf/open/floor/mineral/titanium/blue,/area/shuttle/rebels)
"k" = (/obj/structure/closet/wardrobe/grey,/turf/open/floor/mineral/titanium/blue,/area/shuttle/rebels)
"l" = (/obj/machinery/requests_console{department = "Arrival shuttle"; name = "Arrivals Shuttle console"; pixel_y = 30},/obj/machinery/light{dir = 1},/turf/open/floor/mineral/titanium/blue,/area/shuttle/rebels)
"m" = (/obj/structure/shuttle/engine/heater{dir = 4},/obj/structure/window/reinforced{dir = 8},/turf/open/floor/plating/airless,/area/shuttle/rebels)
"n" = (/obj/structure/shuttle/engine/propulsion/burst/right{dir = 4},/turf/open/floor/plating/airless,/area/shuttle/rebels)
"o" = (/obj/structure/window/shuttle,/obj/structure/grille,/turf/open/floor/plating,/area/shuttle/rebels)
"p" = (/obj/structure/chair/comfy/shuttle,/turf/open/floor/mineral/titanium/blue,/area/shuttle/rebels)
"q" = (/obj/structure/chair/comfy/shuttle,/obj/machinery/light/small{dir = 4},/turf/open/floor/mineral/titanium/blue,/area/shuttle/rebels)
"r" = (/turf/open/floor/mineral/titanium,/area/shuttle/rebels)
"s" = (/obj/structure/chair/comfy/shuttle{dir = 8},/turf/open/floor/mineral/titanium,/area/shuttle/rebels)
"t" = (/obj/structure/shuttle/engine/propulsion{dir = 4},/turf/open/floor/plating/airless,/area/shuttle/rebels)
"u" = (/obj/machinery/door/airlock/titanium{name = "Arrivals Shuttle Airlock"},/turf/open/floor/mineral/titanium,/area/shuttle/rebels)
"v" = (/obj/structure/shuttle/engine/propulsion{dir = 4},/obj/docking_port/mobile/rebels,/turf/open/floor/plating/airless,/area/shuttle/rebels)
"w" = (/obj/structure/chair/comfy/shuttle{dir = 1},/turf/open/floor/mineral/titanium/blue,/area/shuttle/rebels)
"x" = (/obj/structure/chair/comfy/shuttle{dir = 1},/obj/machinery/light/small{dir = 4},/turf/open/floor/mineral/titanium/blue,/area/shuttle/rebels)
"y" = (/obj/structure/closet/emcloset,/turf/open/floor/mineral/titanium/blue,/area/shuttle/rebels)
"z" = (/obj/machinery/light,/turf/open/floor/mineral/titanium/blue,/area/shuttle/rebels)
"A" = (/obj/item/radio/intercom{name = "Station Intercom (General)"; pixel_y = -29},/obj/machinery/light,/turf/open/floor/mineral/titanium/blue,/area/shuttle/rebels)
"B" = (/obj/structure/shuttle/engine/propulsion/burst/left{dir = 4},/turf/open/floor/plating/airless,/area/shuttle/rebels)

(1,1,1) = {"
aaabbcbddddbcbb
bbbbefghijklfmn
opqbrsfsfsfsrmt
drrursfsfsfsrmv
dwxbrsfsfsfsrmt
bbbbyfzffffAfmB
aaabbcbddddbcbb
"}
