"aa" = (/turf/open/space/basic,/area/bluespaceriver/ship)
"ab" = (/turf/open/mask{temperature = 230},/area/bluespaceriver/ground)
"ac" = (/obj/machinery/vending/boozeomat,/turf/open/space/basic,/area/bluespaceriver/ship)
"ad" = (/obj/structure/flora/grass/brown,/turf/open/floor/exoplanet/snow{temperature = 240},/area/bluespaceriver/ground)
"ae" = (/obj/structure/flora/tree/pine,/turf/open/floor/exoplanet/snow{temperature = 240},/area/bluespaceriver/ground)
"af" = (/obj/structure/flora/bush,/turf/open/floor/exoplanet/snow{temperature = 240},/area/bluespaceriver/ground)
"ag" = (/obj/structure/flora/bush,/obj/structure/flora/grass/both,/turf/open/floor/exoplanet/snow{temperature = 240},/area/bluespaceriver/ground)
"ah" = (/obj/structure/flora/grass/green,/turf/open/floor/exoplanet/snow{temperature = 240},/area/bluespaceriver/ground)
"ai" = (/obj/structure/flora/grass/both,/turf/open/floor/exoplanet/snow{temperature = 240},/area/bluespaceriver/ground)
"aj" = (/obj/structure/flora/ausbushes/brflowers,/turf/open/floor/exoplanet/snow{temperature = 240},/area/bluespaceriver/ground)
"ak" = (/obj/machinery/smartfridge/chemistry,/turf/open/space/basic,/area/bluespaceriver/ship)
"al" = (/obj/structure/shuttle/engine/propulsion{icon_state = "propulsion_l"},/turf/open/space/basic,/area/bluespaceriver/ship)
"am" = (/obj/machinery/door/window/northright,/obj/machinery/door/window/southleft,/turf/open/space/basic,/area/bluespaceriver/ship)
"an" = (/turf/open/floor,/area/bluespaceriver/ship)
"ao" = (/obj/machinery/computer/monitor,/turf/open/floor/tiled,/area/bluespaceriver/ship)
"ap" = (/obj/machinery/computer/security,/turf/open/floor/tiled,/area/bluespaceriver/ship)
"aq" = (/obj/machinery/computer/station_alert,/turf/open/floor/tiled,/area/bluespaceriver/ship)
"ar" = (/obj/machinery/computer/atmos_alert,/turf/open/floor/tiled,/area/bluespaceriver/ship)
"as" = (/obj/machinery/light,/turf/open/floor/exoplanet/snow{temperature = 240},/area/bluespaceriver/ship)
"at" = (/obj/structure/table/reinforced,/turf/open/floor/tiled,/area/bluespaceriver/ship)
"au" = (/obj/machinery/power/apc{dir = 8; pixel_x = -24},/obj/structure/cable{icon_state = "0-2"; d2 = 2},/turf/open/space/basic,/area/bluespaceriver/ship)
"av" = (/obj/structure/cable,/turf/open/space/basic,/area/bluespaceriver/ship)
"aw" = (/obj/machinery/light{dir = 1},/obj/structure/closet/wardrobe/science_white,/turf/open/space/basic,/area/bluespaceriver/ship)
"ax" = (/obj/structure/closet/radiation,/turf/open/space/basic,/area/bluespaceriver/ship)
"ay" = (/obj/machinery/light{dir = 1},/turf/open/space/basic,/area/bluespaceriver/ship)
"az" = (/obj/machinery/shieldwallgen,/turf/open/space/basic,/area/bluespaceriver/ship)
"aA" = (/obj/structure/sign/warning/vacuum,/turf/open/space/basic,/area/bluespaceriver/ship)
"aB" = (/obj/machinery/door/airlock/command,/turf/open/floor/tiled,/area/bluespaceriver/ship)
"aC" = (/obj/machinery/light{dir = 4; icon_state = "tube1"},/turf/open/space/basic,/area/bluespaceriver/ship)
"aD" = (/obj/machinery/computer/rdconsole,/turf/open/floor/tiled,/area/bluespaceriver/ship)
"aE" = (/obj/machinery/light{dir = 1},/turf/open/floor/tiled,/area/bluespaceriver/ship)
"aF" = (/obj/machinery/light{dir = 8},/turf/open/space/basic,/area/bluespaceriver/ship)
"aG" = (/obj/machinery/door/airlock/science,/turf/open/floor/tiled,/area/bluespaceriver/ship)
"aH" = (/obj/structure/ore_box,/turf/open/space/basic,/area/bluespaceriver/ship)
"aI" = (/obj/item/pizzabox,/obj/machinery/light{dir = 1},/turf/open/floor/tiled,/area/bluespaceriver/ship)
"aS" = (/obj/machinery/microwave,/turf/open/floor/tiled,/area/bluespaceriver/ship)
"aV" = (/obj/machinery/chem_master,/turf/open/floor/tiled,/area/bluespaceriver/ship)
"ba" = (/turf/open/floor/plating,/area/bluespaceriver/ship)
"bh" = (/obj/structure/closet/emcloset,/turf/open/floor/tiled,/area/bluespaceriver/ship)
"bj" = (/obj/machinery/light,/obj/structure/filingcabinet,/turf/open/floor/tiled,/area/bluespaceriver/ship)
"bo" = (/obj/machinery/light{dir = 4; icon_state = "tube1"},/turf/open/floor/exoplanet/snow{temperature = 240},/area/bluespaceriver/ship)
"bp" = (/obj/machinery/autolathe,/turf/open/floor/tiled,/area/bluespaceriver/ship)
"bq" = (/obj/machinery/light,/turf/open/floor/tiled,/area/bluespaceriver/ship)
"bA" = (/obj/structure/table/glass,/turf/open/floor/tiled,/area/bluespaceriver/ship)
"bB" = (/obj/machinery/light{dir = 8},/turf/open/floor/exoplanet/snow{temperature = 240},/area/bluespaceriver/ship)
"bE" = (/obj/machinery/door/airlock,/turf/open/floor/tiled,/area/bluespaceriver/ship)
"bF" = (/obj/machinery/light{dir = 4; icon_state = "tube1"},/turf/open/floor/tiled,/area/bluespaceriver/ship)
"bH" = (/obj/structure/bookcase/manuals/research_and_development,/turf/open/floor/tiled,/area/bluespaceriver/ship)
"bW" = (/turf/open/floor/exoplanet/snow{temperature = 240},/area/bluespaceriver/ship)
"cb" = (/turf/open/floor/tiled,/area/bluespaceriver/ship)
"cy" = (/obj/structure/ladder,/turf/open/floor/exoplanet/snow{temperature = 240},/area/bluespaceriver/ground)
"cA" = (/obj/structure/flora/grass/both,/obj/structure/flora/grass/both,/turf/open/floor/exoplanet/snow{temperature = 240},/area/bluespaceriver/ground)
"cB" = (/obj/structure/flora/grass/both,/obj/structure/flora/bush,/turf/open/floor/exoplanet/snow{temperature = 240},/area/bluespaceriver/ground)
"cC" = (/turf/open/floor/exoplanet/snow{temperature = 240},/area/bluespaceriver/ground)
"cD" = (/turf/open/mineral{temperature = 233},/area/bluespaceriver/ground)

(1,1,1) = {"
cDcDcDcDcDcDcDcDcDcDcDcDcDcDcDcDcDcDcDcDcDcDcDcDcDcDcDcDcDcDcDcDcDcDcDcDcDcDcDcDcDcDcDcDcDcDcDcDcDcDcDcDcDcDcDcDcDcDcDcDcDcDcDcDcDcDcDcDcDcDcDcDcDcDcDcDcDcDcDcDcDcDcDcDcDcDcDcDcDcDcDcDcDcDcDcDcDcDcDcD
cDababababababababababababababababababababababababababababababababababababababababababababababababababababababababababababababababababababababababababababababababababababababababababababababababababcD
cDababababababababababababababababababababababababababababababababababababababababababababababababababababababababababababababababababababababababababababababababababababababababababababababababababcD
cDababababababababababababababababababababababababababababababababababababababababababababababababababababababababababababababababababababababababababababababababababababababababababababababababababcD
cDababababababababababababababababababababababababababababababababababababababababababababababababababababababababababababababababababababababababababababababababababababababababababababababababababcD
cDababababababababababababababababababababababababababababababababababababababababababababababababababababababababababababababababababababababababababababababababababababababababababababababababababcD
cDababababababababababababababababababababababababababababababababababababababcCcCcCabababababababababababababababababababababababababababababababababababababababababababababababababababababababababcD
cDababababababababababababababababababababababababababababababababcCcCcCcCcCababcCcCababababababcCabababcCcCcCcCcCababababababababababababababababababababababababababababababababababababababababababcD
cDababababababababababababababababababababababababababababababababcCcCcCcCcCcCabcCcCcCcCcCabababcCabcCadcCcCcCcCaecCababababababababcCabababcCcCcCcCcCcCcCababababababababababababababababababababababcD
cDababababababababababababababababababababababababababababababcCcCcCcCcCaecCcCcCcCcCcCcCcCababcCcCcCcCcCcCcCcCcCcCcCababababababababcCabababcCcCcCcCcCcCcCcCabababababababababababababababababababababcD
cDababababababababababababababababababababababababababababababcCcCcCcCcCcCcCcCcCcCcCcCcCaecCabcCcCcCcCcCcCcCcCcCcCcCcCcCabababcCcCcCcCababababcCcCcCcCcCcCcCcCababababababababababababababababababababcD
cDababababababababababababababcCcCcCcCcCcCababababcCabababababcCcCcCcCcCcCcCcCcCcCcCcCcCafcCcCcCcCcCcCcCcCcCcCcCcCcCcCababababcCcCcCcCcCabcCabcCcCcCcCcCcCababababababababababababababababababababababcD
cDababababababababababababababcCcCcCcCcCcCcCabababcCcCcCcCcCaecCcCcCcCcCcCcCcCcCadcCcCcCcCcCcCcCcCcCcCcCcCcCcCcCcCcCcCababcCcCcCcCcCcCcCcCcCcCcCcCcCcCcCcCababababababababababababababababababababababcD
cDababababababababababababababcCcCcCcCagcCcCabababcCcCcCcCcCcCcCcCcCahcCcCcCadcCcCcCcCcCcCcCcCcCcCcCcCcCcCcCcCcCcCcCcCcCcCcCcCcCcCcCcCcCcCcCcCcCcCcCcCcCcCababababababababababababababababababababababcD
cDababababababababababababababcCcCcCcCcCcCcCcCcCcCcCcCaicCcCcCcCcCcCcCcCcCcCcCcCcCcCcCcCcCcCcCcCcCcCcCcCadcCcCcCcCcCcCcCcCcCcCcCcCcCcCcCcCcCcCcCcCcCcCcCcCababcCcCcCabcCcCababababababababababababababcD
cDababababababababababababababcCcCcCcCcCcCcCcCcCcCcCcCcCcCcCcCcCcCcCcCcCcCcCcCcCcCcCcCcCcCcCcCcCcCcCcCcCcCcCcCcCcCcCcCcCcCcCcCcCadcCcCcCcCcCcCcCcCcCadcCcCcCcCcCcCcCcCcCababcCababababababababababababcD
cDababababababababababababcCcCcCcCcCcCcCcCcCcCcCcCcCcCcCafcCcCcCcCcCcCcCcCcCcCcCcCcCcCcCcCcCcCcCcCcCcCcCcCcCcCcCcCcCcCcCcCcCcCcCcCcCcCcCcCcCcCcCcCcCcCcCcCcCcCcCcCcCcCcCabcCcCcCcCababababababababababcD
cDababababababababababababcCcCcCcCcCcCcCcCcCcCcCcCcCcCcCcCcCcCcCcCcCcCcCcCcCcCcCcCcCcCafcCcCcCcCcCcCcCcCadcCcCcCcCcCcCcCcCcCcCcCcCcCcCcCcCcCcCcCcCcCcCcCcCcCcCcCcCcCcCcCcCcCcCcCcCababababababababababcD
cDababababababababababababcCcCcCcCcCcCcCcCaecCaicCcCcCcCcCcCcCcCcCcCcCcCcCcCcCafcCcCcCcCcCafcCcCcCcCcCcCcCcCcCcCcCcCcCcCcCcCcCcCcCcCcCcCcCcCcCcCcCcCcCcCcCcCcCcCcCcCcCcCcCcCcCcCcCcCabababababababababcD
cDababababababababababababcCcCcCcCcCcCafcCahcCcCaicCcCcCcCcCcCcCcCcCcCcCcCafaecCcCcCcCcCcCcCcCcCcCcCcCcCcCcCcCcCcCcCcCcCcCcCcCcCaecCcCcCcCcCcCcCcCcCcCcCcCcCcCcCcCcCcCcCcCcCcCcCabababababababababababcD
cDababababababababababababcCcCcCcCcCcCcCcCcCcCcCcCcCcCcCcCcCcCcCcCcCcCcCcCcCcCcCcCcCcCcCcCcCcCcCcCcCcCcCcCcCcCcCcCcCcCcCcCcCcCcCcCcCcCcCcCcCcCcCcCcCcCcCcCcCcCcCcCcCcCcCcCcCcCaicCcCabababababababababcD
cDabababababababababababcCcCcCcCafcCcCcCcCcCcCcCcCcCcCcCcCcCcCcCcCcCcCcCafcCcCcCcCcCcCcCcCcCcCcCcCcCcCcCcCcCcCcCcCcCcCcCcCcCcCcCcCcCcCcCcCcCcCcCaicCcCcCcCcCcCcCcCcCcCcCcCcCcCcCcCababababababababababcD
cDabababababababababababcCcCcCafcCcCcCcCcCcCcCcCcCcCcCcCcCcCcCcCafcCcCcCcCcCafcCcCcCcCcCcCcCcCcCcCcCcCcCcCcCcCcCcCcCcCcCcCcCcCcCcCcCcCcCcCcCcCcCcCcCcCcCcCcCcCcCcCcCcCcCcCcCcCcCabababababababababababcD
cDabababababababababababcCcCcCcCcCcCcCcCcCcCcCcCcCcCcCcCcCcCcCcCcCcCcCcCcCcCcCcCcCcCcCcCcCcCafcCcCcCcCcCcCcCcCcCcCcCcCcCcCcCcCcCcCcCcCcCcCcCcCcCcCcCcCaecCcCcCcCcCcCcCcCcCcCcCcCcCababababababababababcD
cDabababababababababababcCcCcCcCcCcCcCcCcCcCcCcCajcCcCcCcCcCcCcCcCcCcCcCcCcCcCcCcCcCcCcCcCcCcCcCcCcCcCcCcCcCcCcCcCcCcCcCcCcCcCcCcCcCcCcCcCcCcCcCcCcCcCcCcCcCcCcCcCcCcCcCcCcCcCcCcCababababababababababcD
cDababababababababababababcCcCcCcCcCcCcCcCcCcCcCcCcCcCcCcCadcCcCcCcCcCcCcCcCcCcCcCafcCcCaicCcCcCcCcCcCcCcCcCcCcCcCcCcCcCcCcCcCcCcCcCcCcCcCcCcCcCcCcCcCcCcCcCcCcCcCcCcCcCcCcCcCcCcCcCcCababababababababcD
cDababababababababababcCcCcCcCcCcCcCcCcCcCcCcCcCcCcCcCcCcCcCcCcCaecCcCcCcCcCcCcCcCcCcCcCcCcCcCcCcCcCcCcCcCcCcCcCcCcCcCcCcCcCcCcCcCcCcCcCcCcCaicCcCcCcCcCcCcCcCcCcCcCcCcCcCcCcCcCcCcCabababababababababcD
cDababababababababcCcCcCcCcCcCcCcCcCcCcCcCcCcCcCcCcCcCcCcCcCcCcCcCcCcCcCcCcCcCcCcCcCcCcCcCaicCcCcCcCcCcCcCcCcCcCcCcCcCcCcCcCcCcCcCcCcCcCcCcCcCcCcCcCcCcCcCcCadcCcCcCaeaicCcCcCcCcCababababababababababcD
cDababababababababcCcCcCcCadcCahcCcCcCcCcCcCcCcCcCcCcCcCcCcCcCcCcCcCcCcCcCcCcCcCcCcCcCcCcCcCcCcCcCcCcCcCcCcCcCcCcCcCcCcCcCcCcCcCcCcCcCcCcCcCcCcCcCcCcCcCcCcCcCcCcCcCcCcCcCcCcCcCcCcCabababababababababcD
cDababababababababcCcCcCcCcCcCcCcCcCcCcCcCcCcCcCcCcCcCcCcCcCcCcCcCcCcCcCahcCcCcCcCcCcCcCcCcCcCcCcCcCcCcCcCcCcCcCcCcCcCcCcCcCcCcCcCcCcCcCcCcCcCcCcCcCcCcCcCcCcCcCcCcCcCcCcCcCcCcCabababababababababababcD
cDababababababcCcCcCcCcCcCcCcCcCcCcCcCcCcCcCcCcCcCcCcCcCcCcCcCafcCcCcCcCcCcCcCcCcCcCcCcCcCcCcCcCcCcCcCcCcCcCcCcCcCcCcCcCcCcCcCcCcCcCcCcCcCcCcCcCcCcCcCcCcCcCcCcCcCcCcCcCcCcCcCababababababababababababcD
cDabababababababcCcCcCcCcCcCcCcCcCcCcCcCcCcCcCcCcCcCcCcCcCahcCcCcCcCcCcCcCcCcCcCcCcCcCcCcCcCcCcCcCcCcCcCcCcCcCcCcCcCcCcCcCcCcCcCcCcCcCcCcCcCcCcCcCcCcCcCcCcCcCcCcCcCcCcCcCcCcCcCcCababababababababababcD
cDabababababcCabcCcCcCcCcCcCcCcCcCcCcCcCcCcCcCcCcCcCcCcCcCcCcCcCcCcCcCcCcCcCcCcCcCcCcCcCcCcCcCcCcCcCcCcCcCcCcCcCcCcCcCcCcCcCcCcCcCcCcCcCcCcCcCcCcCcCcCcCcCcCcCcCcCcCcCcCcCcCcCcCcCababababababababababcD
cDabababababcCcCcCcCcCcCcCcCcCcCcCcCcCcCcCcCcCcCcCcCcCcCcCcCcCcCcCcCcCcCcCcCcCcCahcCcCcCcCcCcCcCcCcCcCcCcCcCcCcCcCcCcCcCcCcCcCcCafcCcCcCcCcCcCcCcCcCcCcCcCcCcCcCcCcCcCcCcCcCcCcCcCababababababababababcD
cDababababababcCcCcCcCcCcCcCcCcCcCcCcCcCcCcCcCcCcCcCcCcCcCcCcCcCcCcCcCcCcCcCcCcCcCcCaecCcCcCcCcCcCcCcCcCcCcCcCcCcCcCcCcCcCcCcCcCcCcCcCcCcCcCcCcCcCcCcCcCcCcCcCcCcCcCcCcCcCcCcCcCcCababababababababababcD
cDababababababcCcCcCcCcCcCcCcCcCcCcCcCcCanananananancCcCcCcCcCcCcCcCcCcCcCcCcCcCcCcCcCcCcCcCcCcCcCahcCcCcCcCcCcCcCcCcCcCcCcCcCcCcCcCcCcCcCcCcCcCcCcCcCcCcCcCcCcCcCcCcCcCcCaecCcCcCababababababababababcD
cDababababababcCcCcCcCcCcCcCcCcCcCcCcCananaoapaqaranancCcCcCcCcCcCcCcCcCcCcCcCcCcCcCaicCcCcCcCcCcCcCcCcCcCcCcCcCcCcCcCcCcCcCcCcCcCcCcCcCcCcCcCcCcCcCcCcCcCcCcCcCcCcCcCcCcCcCcCcCcCababababababababababcD
cDababababababcCcCcCcCcCcCcCcCcCcCasananatcbcbcbbqcbananascCcCcCcCcCcCcCcCcCcCcCcCcCcCcCcCcCcCcCcCcCcCcCcCcCcCcCcCcCcCcCcCcCcCcCcCcCcCcCcCcCcCcCcCcCcCcCcCcCcCcCcCcCcCcCcCcCcCcCcCababababababababababcD
cDababababababcCcCcCcCcCcCcCcCcCcCaaanaaaaaaaaaaaaaBacanaacCcCcCcCcCcCcCcCcCcCcCcCcCcCcCcCcCcCcCcCcCcCcCcCcCcCcCcCcCcCcCcCcCcCcCcCcCcCcCcCcCcCcCcCcCcCcCcCcCcCcCcCcCcCcCcCcCcCcCcCcCcCababababababababcD
cDababababababcCcCcCcCcCcCcCcCcCanaaaDaEcbaGcbaIcbcbcbcbaaancCcCcCcCcCcCcCcCcCcCcCcCcCcCcCcCcCcCcCcCcCcCcCcCcCcCcCaicCcCcCcCcCcCcCcCcCcCcCcCcCcCcCcCcCcCcCcCcCcCcCcCcCcCcCcCcCcCcCcCabababababababababcD
cDabababababcCcCcCcCcCcCcCcCcCanancbcbcbcbakcbcbcbcbcbcbaSanancCcCcCcCcCcCcCaicCcCcCcCcCcCcCcCcCcCcCcCcCafcCcCcCcCaicCcCcCcCcCcCcCcCcCcCcCcCcCcCcCcCcCcCcCcCcCcCcCcCcCcCcCcCcCcCcCcCabababababababababcD
cDabababababcCcCcCcCcCcCcCcCanancbcbcbcbaVaacbcbcbcbcbcbbFaaanancCcCcCcCcCcCcCcCcCcCcCcCcCcCaicCcCcCcCcCcCcCcCcCcCcCcCcCcCcCcCcCcCcCcCcCcCcCcCcCcCcCcCcCcCcCaicCcCcCcCcCcCcCcCcCcCcCcCcCabababababababcD
cDabababababcCcCcCcCcCcCcCbabacbcbcbbFaaaaaacbbhcbbjcbcbcbaacbanancCcCcCcCcCcCcCcCcCcCcCcCcCcCcCcCcCcCcCcCcCcCcCcCcCcCcCcCcCcCcCcCcCcCcCcCcCcCcCcCcCcCcCcCcCcCcCcCcCcCcCcCcCcCcCcCcCcCababababababababcD
cDabababababcCcCadcCcCboaaaabpcbcbbqcbaaaabEcbaacbaacbaacbaGcbbAaaaabBcCcCcCcCcCcCcCcCcCcCcCcCcCcCcCcCcCcCaecCcCcCcCcCcCcCcCcCcCafcCcCcCcCcCcCcCcCcCcCcCcCcCcCcCcCcCcCcCcCcCcCcCcCcCabababababababababcD
cDababababababcCcCcCcCcCalalaaaaamaaaaaaaaaabEaaaaaaaaaabFaaaaaaalalcCcCcCcCcCcCcCcCcCcCcCcCcCcCcCcCcCcCcCcCcCcCcCcCaicCcCcCcCcCcCcCcCcCcCcCcCcCcCcCcCcCcCcCcCcCcCcCcCcCcCcCcCcCcCcCabababababababababcD
cDababababababcCcCcCcCcCcCcCalaaaaaaaabHcbcbcbcbcbcbbHaaauaaaaalcCcCcCcCcCcCcCcCcCcCcCcCcCcCcCcCcCcCcCcCcCcCcCcCcCcCcCcCcCcCcCcCcCcCcCcCcCcCcCcCcCaecCcCcCcCcCcCcCcCcCcCcCcCcCcCcCcCcCababababababababcD
cDababababababcCcCcCcCcCcCcCcCaaaaaaaaaaaaaacbcbaaaaaaaaavaaaabWcCcCcCcCcCcCcCcCcCcCcCcCcCahcCcCcCcCcCcCcCcCcCcCcCcCcCcCcCcCcCcCcCcCcCcCcCcCcCcCcCcCcCcCcCcCcCcCcCcCcCcCcCcCcCaicCaiabababababababababcD
cDababababcCcCcCcCcCcCcCcCcCcCalaaaaaabHcbcbcbcbcbcbcbaaaaaaalcCcCcCcCcCcCcCcCcCcCcCcCcCcCcCcCcCcCcCcCcCcCcCcCcCcCcCcCcCcCcCcCcCafcCcCcCcCcCcCcCaicCcCcCcCcCcCcCaicCcCcCcCcCcCcCcCcCabababababababababcD
cDababababcCcCcCcCcCcCcCcCcCcCcCalaaaaaaaaaacbcbaaaaaaaaaaalcCcCcCcCcCcCcCcCcCcCcCcCcCcCcCcCcCcCcCcCcCcCcCcCcCcCcCcCcCcCcCcCcCcCcCcCcCcCcCcCcCaiaicCcCcCcCcCcCcCcCcCcCcCcCcCcCcCcCcCcCababababababababcD
cDababababababahcCcCcCcCcCcCcCcCcCaaaaaaawaxaaaaaaayaaaaaacCcCcCcCcCcCcCcCcCcCcCcCcCcCcCcCcCcCcCcCcCcCcCcCcCcCcCcCcCcCcCcCcCcCcCcCcCcCcCcCcCcCcCcCcCcCcCcCcCcCaicCcCcCcCcCcCcCcCcCcCcCababababababababcD
cDabababababababcCcCcCcCcCcCcCcCcCalaaaaaaaaazazaAaaaaaaalcCcCcCcCcCcCcCcCcCcCcCcCcCcCcCcCcCcCcCcCcCcCcCcCcCcCaicCcCcCcCcCcCcCcCcCcCcCcCcCcCcCcCcCcCcCcCcCcCcCcCcCcCcCcCcCcCcCcCcCcCcCababababababababcD
cDabababababababababcCcCcCcCcCcCcCcCaaaaaaaaaaaaaaaaaCaacCcCcCcCcCcCcCcCcCcCcCcCcCcCcCcCcCcCcCcCcCcCcCcCcCcCcCcCcCaecCcCcCcCcCcCcCcCcCcCcCcCcCcCcCcCcCcCcCcCcCcCcCcCcCcCcCcCcCcCcCcCcCcCabababababababcD
cDabababababababababcCcCcCcCcCcCcCcCaaaaaAaFaaaaaaaaaHaacCcCcCcCcCcCcCcCcCcCcCcCcCcCcCcCcCcCcCcCcCcCcCcCcCcCcCcCcCcCcCcCcCcCcCcCcCcCaicCcCcCcCcCcCcCcCcCcCcCcCcCcCcCcCcCcCcCcCcCcCcCabababababababababcD
cDabababababababababcCcCcCcCcCcCcCcCaaaaaaaaaaaaaaaaaaaacCcCcCcCcCcCcCcCcCcCcCcCcCcCcCcCcCcCcCcCcCcCcCcCcCcCcCcCcCcCcCcCcCcCcCcCcCcCcCcCcCcCcCcCcCcCcCcCcCcCcCcCcCcCcCcCcCcCcCcCcCcCabababababababababcD
cDabababababababababcCcCcCcCcCcCcCcCcCcCcCcCcCcCcCcCcCcCcCcCcCcCcCcCcCcCcCcCcCcCcCcCcCcCcCcCcCcCcCcCcCcCcCcCcCcCcCcCcCcCcCcCcCcCcCcCcCcCcCcCcCcCcCcCcCcCcCcCcCcCcCcCcCcCcCcCcCcCcCcCabababababababababcD
cDabababababababababcCcCcCcCcCcCcCcCcCcCcCcCcCcCcCcCcCcCcCcCcCcCcCcCcCcCcCcCcCcCcCcCcCcCcCcCcCcCcCcCcCcCcCcCcCcCcCcCcCcCcCcCcCcCcCcCcCcCcCcCcCcCcCcCcCcCcCcCcCcCcCcCcCcCcCcCcCcCabababababababababababcD
cDababababababababababcCcCcCcCcCcCcCcCcCcCcCcycCcCcCcCcCcCcCcCcCcCcCcCcCcCcCcCcCcCcCcCcCcCcCcCcCcCcCcCcCcCcCcCcCcCcCcCcCcCcCcCcCcCcCcCcCcCcCcCcCcCcCcCcCcCcCcCcCcCcCcCcCcCcCcCcCcCababababababababababcD
cDababababababababababcCahcCcCcCcCcCcCcCcCcCcCcCcCcCcCcCcCcCcCcCcCcCcCcCcCcCcCcCcCcCcCcCcCcCcCcCcCcCcCcCcCcCcCcCcCcCcCcCcCcCcCcCcCcCcCcCcCcCcCcCcCcCcCcCcCcCcCcCcCcCcCcCcCcCcCcCabababababababababababcD
cDababababababcCcCcCcCcCcCcCcCcCcCcCcCcCcCcCcCcCcCcCcCcCcCcCcCcCcCcCcCcCcCcCcCcCcCcCcCcCcCcCcCcCcCcCcCcCcCcCcCcCaecCcCcCcCcCcCcCcCcCcCcCcCcCcCcCcCcCcCcCcCcCcCcCcCcCcCcCcCcCcCababababababababababababcD
cDabababababcCcCcCcCcCcCcCcCcCcCcCcCcCcCcCcCcCcCcCcCcCcCcCcCcCcCcCcCcCcCcCcCcCcCcCcCcCcCcCcCcCcCcCcCcCcCcCcCcCcCcCcCcCcCcCcCcCcCcCcCcCcCcCcCcCcCcCcCcCcCcCcCcCcCcCcCcCcCaecCcCcCcCcCabababababababababcD
cDababababababcCcCcCcCcCcCcCcCcCcCcCcCcCcCcCcCcCcCcCcCcCcCcCcCcCcCcCcCcCcCaicCcCcCcCcCcCcCcCcCcCcCcCcCcCcCcCcCcCcCcCcCcCcCcCcCcCcCcCcCcCcCcCcCcCcCcCcCcCcCcCcCcCcCcCcCcCcCcCcCcCcCcCcCcCabababababababcD
cDabababababcCcCcCcCcCcCcCcCcCcCcCcCcCcCcCcCcCcCcCcCcCcCcCcCcCcCcCcCcCcCcCcCcCcCcCcCcCcCcCcCcCcCcCcCcCcCcCcCcCcCcCcCcCcCcCcCcCcCcCcCcCcCcCcCcCcCcCcCcCcCcCcCcCcCcCcCcCcCcCcCcCcCcCcCcCcCabababababababcD
cDababababcCcCcCcCcCcCcCcCcCcCcCcCcCcCcCcCcCcCcCcCcCcCafcCcCcCcCcCcCcCcCcCcCcCcCcCcCcCcCcCcCcCcCcCcCcCcCcCcCcCcCcCcCcCcCcCcCcCcCcCcCcCcCcCcCcCcCcCcCcCcCcCcCcCcCcCcCcCcCcCcCcCcCcCcCcCcCabababababababcD
cDababababcCcCcCcCcCcCcCcCcCcCcCcCcCcCcCcCcCcCcCcCcCcCcCcCcCcCcCcCcCcCcCcCcCcCcCcCcCcCcCcCcCcCcCcCcCcCcCcCcCcCcCcCcCcCcCcCcCcCcCcCcCcCcCcCcCcCcCcCcCcCcCcCcCcCcCcCcCcCcCcCcCcCcCcCcCabababababababababcD
cDababababcCabcCcCcCcCcCcCaicCcCcAcCcBcCcCcCcCcCcCcCcCcCcCcCcCcCcCcCcCcCcCcCcCcCcCcCcCcCcCcCcCcCcCcCcCcCcCcCcCcCcCcCcCcCcCcCcCcCcCcCcCcCcCcCcCcCcCcCcCcCcCcCcCcCcCcCcCcCcCcCcCcCcCcCabababababababababcD
cDababababababcCaicCcCcCcCcCcCcCcCcCcCcCcCcCcCcCcCcCcCcCcCcCcCcCcCcCcCcCcCcCcCcCcCcCaecCcCcCcCcCcCcCcCcCcCcCcCaicCcCcCcCcCcCcCcCcCcCcCcCcCcCcCcCcCcCcCcCcCcCcCcCcCcCcCcCcCcCcCcCcCababababababababababcD
cDababababababcCcCcCcCcCcCcCcCcCcCcCcCcCcCcCcCcCcCcCcCcCcCcCcCcCcCcCcCcCcCcCcCcCcCcCcCcCcCcCcCcCcCcCcCcCcCcCcCcCcCcCcCcCcCcCcCcCcCcCcCcCcCcCcCcCcCcCcCcCcCcCcCcCcCcCcCcCcCcCcCcCcCababababababababababcD
cDabababababcCcCcCcCcCcCcCcCcCcCcCcCcCcCcCcCcCcCcCcCcCcCcCcCcCcCcCcCcCcCcCcCcCcCcCcCcCcCcCcCcCcCcCcCcCcCcCcCcCcCcCcCcCcCcCcCcCcCcCcCcCcCcCcCcCcCcCcCcCcCcCcCcCcCcCcCcCcCcCcCcCcCcCcCabababababababababcD
cDababababcCcCcCcCcCcCcCcCcCcCcCcCcCcCcCcCcCcCcCcCcCcCcCcCcCcCcCcCcCcCcCcCcCcCcCcCcCcCcCcCcCcCcCcCcCcCcCcCcCcCcCcCcCcCcCcCcCcCcCcCcCcCcCcCcCcCcCcCcCcCcCcCcCcCcCcCcCcCcCcCcCcCcCcCcCcCcCabababababababcD
cDabababababcCcCcCcCcCcCcCcCcCcCcCafcCcCcCcCcCcCcCcCcCcCcCcCcCcCcCcCcCcCcCcCcCaicCcCcCcCcCcCcCcCcCcCcCcCcCcCcCcCcCaecCcCcCcCcCcCcCcCcCcCcCcCcCcCcCcCcCcCcCcCcCcCcCcCaecCcCcCcCcCcCcCcCcCabababababababcD
cDabababababcCcCcCcCcCcCcCcCcCcCcCcCcCcCcCcCcCaicCcCcCcCcCcCcCcCcCcCcCcCcCcCcCcCcCcCcCafaicCcCcCcCcCcCcCcCcCcCcCcCcCcCcCcCcCcCcCcCcCcCcCcCcCcCcCcCcCcCcCcCcCcCcCcCcCcCcCcCcCcCcCcCaicCcCcCababababababcD
cDabababababcCcCcCafcCcCcCcCcCcCcCcCcCcCcCcCcCcCcCcCcCcCcCcCcCcCcCcCcCcCcCcCcCcCcCcCcCcCcCcCcCcCcCcCcCcCcCcCcCcCcCcCcCcCcCcCcCcCcCcCcCcCcCcCcCcCcCcCcCcCcCcCcCcCcCcCcCcCcCcCcCcCcCcCcCcCabababababababcD
cDabababababcCcCcCcCcCcCcCcCcCaecCcCcCcCcCcCcCcCcCcCcCcCcCcCcCcCcCcCcCcCcCcCcCcCcCcCcCcCcCcCcCcCcCcCcCcCcCcCcCcCcCcCcCcCcCcCcCcCcCcCcCcCcCcCcCcCcCcCcCcCcCcCcCcCcCcCcCcCcCcCcCcCcCcCcCcCabababababababcD
cDabababababcCcCcCcCcCcCcCcCcCcCcCcCcCcCaicCcCcCcCcCcCcCcCcCcCcCcCcCcCcCcCcCcCcCcCcCcCcCcCcCcCcCcCcCcCcCcCcCcCcCcCcCcCcCcCcCcCcCcCcCcCcCcCcCcCcCcCcCcCcCcCcCcCcCcCcCcCcCcCcCcCcCcCcCcCababababababababcD
cDabababababcCcCcCcCcCcCcCcCcCcCcCcCcCaicCcCcCcCcCcCcCcCcCcCcCcCcCcCcCcCcCcCcCcCcCcCcCcCcCcCcCcCcCcCcCcCcCcCcCcCcCcCcCcCcCcCcCcCcCcCcCcCcCcCcCcCcCcCcCcCcCcCcCcCcCcCcCcCcCcCcCcCcCcCcCababababababababcD
cDabababababcCcCcCcCcCcCcCcCcCcCcCcCcCcCcCcCcCcCcCcCcCcCcCcCcCaicCcCcCcCcCcCcCcCcCcCcCcCcCcCcCcCcCcCcCcCaecCcCcCcCcCcCcCcCcCcCcCcCcCcCcCcCcCcCcCcCcCcCcCcCcCcCcCcCcCcCcCcCcCcCcCcCcCabababababababababcD
cDababababababcCcCcCcCcCcCcCcCcCcCcCcCcCcCcCcCcCcCcCcCcCcCcCcCcCcCcCaicCaecCcCcCcCcCcCcCcCcCcCcCcCcCcCcCaicCaicCcCcCcCcCcCcCcCcCcCcCcCcCcCcCcCcCcCcCcCcCcCcCcCcCcCcCcCcCcCcCcCabcCababababababababababcD
cDababababababcCcCcCcCcCcCcCcCcCcCcCcCcCcCcCcCcCcCcCcCcCcCcCcCcCcCcCcCcCcCcCcCcCcCcCcCcCcCcCcCcCcCcCcCcCcCcCcCcCcCcCcCcCcCcCcCcCcCcCcCcCcCcCcCcCcCcCcCcCcCcCcCcCcCcCcCcCcCcCcCababababababababababababcD
cDababababababcCcCcCcCcCcCcCcCcCcCcCcCcCcCcCcCcCcCcCcCcCcCcCcCcCcCcCcCcCcCcCcCcCcCcCcCcCcCcCcCcCcCcCcCcCcCcCcCcCcCcCcCcCcCcCcCcCcCcCcCcCcCcCcCcCcCcCcCaicCcCcCcCcCcCcCcCcCcCabababababababababababababcD
cDababababababababcCcCcCcCcCcCcCcCcCcCcCcCcCcCcCcCcCcCcCcCcCcCcCcCcCcCcCcCcCcCcCcCcCcCcCcCcCcCcCcCcCcCcCcCcCcCcCcCcCcCcCcCcCcCcCcCcCcCcCcCcCcCcCcCcCcCcCcCcCcCcCcCcCcCcCcCcCabababababababababababababcD
cDabababababababcCcCcCcCcCcCcCcCcCcCcCcCcCcCcCcCcCcCcCcCcCcCcCcCcCcCcCcCcCcCcCcCcCcCcCcCcCcCcCcCafcCcCcCcCcCcCcCcCcCcCcCafcCcCcCcCcCcCcCcCcCcCcCcCcCcCcCcCcCcCcCcCcCcCcCcCababababababababababababababcD
cDabababababababcCcCcCcCcCcCcCcCcCcCcCcCcCcCcCcCcCcCcCcCcCcCcCcCcCcCcCcCcCcCcCcCcCcCcCcCcCcCcCcCcCcCcCcCcCcCcCcCcCcCcCcCcCcCcCcCcCcCcCcCcCcCcCcCcCcCcCcCcCcCcCcCcCcCcCcCcCcCabababababababababababababcD
cDababababcCcCcCcCcCcCcCcCcCcCcCcCcCcCcCcCcCaecCcCcCcCaicCaicCcCcCcCcCcCcCcCcCcCcCcCcCcCcCcCcCcCaecCcCcCcCcCcCcCcCcCcCcCcCcCcCcCcCcCcCcCcCcCcCcCcCcCcCcCcCcCcCcCcCcCcCcCcCcCabababababababababababababcD
cDababababababcCcCcCcCcCaicCcCcCcCcCcCcCcCcCcCcCcCcCcCcCcCcCcCcCcCcCcCcCcCcCcCcCcCcCcCcCcCcCcCcCcCcCcCcCcCcCcCcCcCcCcCcCcCcCcCcCcCcCcCcCcCcCcCcCcCcCcCcCcCcCcCcCcCcCcCcCcCababababababababababababababcD
cDabababababababcCcCcCaicCcCcCcCcCcCcCcCcCcCcCcCcCcCcCcCcCcCcCcCcCcCcCcCcCcCcCcCcCcCcCcCcCcCcCcCcCcCcCcCcCcCcCcCcCcCcCcCcCcCcCcCcCcCcCcCcCcCcCcCcCcCcCcCcCcCcCcCcCcCabababababababababababababababababcD
cDabababababababcCcCcCcCcCcCcCcCcCcCcCcCcCcCcCcCcCcCcCcCcCcCcCcCcCcCcCcCcCcCcCcCcCcCcCcCcCcCcCcCcCcCcCcCcCcCcCcCcCcCcCcCcCaecCcCcCcCcCcCcCcCcCcCcCcCcCcCcCcCcCcCcCcCabababababababababababababababababcD
cDabababababababcCcCcCcCcCcCcCcCcCcCcCcCcCcCaicCcCcCcCcCcCcCcCcCcCcCcCcCcCcCcCcCababababcCcCcCcCcCcCcCcCcCcCcCcCcCcCcCcCcCcCcCcCcCcCcCcCcCcCcCcCcCcCcCcCcCcCcCababababababababababababababababababababcD
cDabababababababcCcCcCcCcCcCcCcCcCcCcCcCcCcCcCcCcCcCcCcCcCcCcCcCcCcCcCcCcCcCcCcCababababcCcCcCcCafcCcCcCcCcCcCcCcCcCcCcCcCcCcCcCcCcCcCcCcCcCcCcCcCababababcCabababababababababababababababababababababcD
cDabababababcCcCcCcCcCcCcCcCcCcCcCcCcCcCcCcCcCcCcCcCcCcCcCcCcCcCcCcCcCcCcCcCcCcCabababababcCcCcCcCcCcCcCcCcCcCcCcCcCcCcCcCcCcCcCcCcCcCcCcCcCcCcCabababababababababababababababababababababababababababcD
cDababababcCcCcCcCcCcCcCcCcCcCcCcCcCcCcCcCcCcCcCcCcCcCcCcCcCcCcCcCcCcCcCcCababababababababcCcCcCababcCcCcCcCcCcCcCcCcCcCcCcCaicCabcCcCcCcCcCcCcCabababababababababababababababababababababababababababcD
cDabababababababababababcCcCcCcCcCcCcCcCcCcCcCcCcCcCcCcCcCcCcCcCcCcCcCcCcCababababababababcCcCcCabababcCcCcCcCcCcCcCcCcCcCcCaicCabababcCcCcCcCababababababababababababababababababababababababababababcD
cDababababababababababababababababcCcCcCcCcCcCcCcCcCcCcCcCcCcCcCcCcCcCabababababababababababcCcCababababcCcCcCcCcCcCcCcCcCcCcCcCababababcCababababababababababababababababababababababababababababababcD
cDababababababababababababababababababababcCcCcCcCcCababababcCcCcCabababababababababababababcCababababababcCcCcCcCcCcCcCcCcCcCababababababababababababababababababababababababababababababababababababcD
cDabababababababababababababababababababababababababababababababababababababababababababababcCababababababcCcCabcCcCcCcCcCababababababababababababababababababababababababababababababababababababababcD
cDabababababababababababababababababababababababababababababababababababababababababababababababababababababababcCcCcCababababababababababababababababababababababababababababababababababababababababcD
cDababababababababababababababababababababababababababababababababababababababababababababababababababababababababababababababababababababababababababababababababababababababababababababababababababcD
cDababababababababababababababababababababababababababababababababababababababababababababababababababababababababababababababababababababababababababababababababababababababababababababababababababcD
cDababababababababababababababababababababababababababababababababababababababababababababababababababababababababababababababababababababababababababababababababababababababababababababababababababcD
cDababababababababababababababababababababababababababababababababababababababababababababababababababababababababababababababababababababababababababababababababababababababababababababababababababcD
cDcDcDcDcDcDcDcDcDcDcDcDcDcDcDcDcDcDcDcDcDcDcDcDcDcDcDcDcDcDcDcDcDcDcDcDcDcDcDcDcDcDcDcDcDcDcDcDcDcDcDcDcDcDcDcDcDcDcDcDcDcDcDcDcDcDcDcDcDcDcDcDcDcDcDcDcDcDcDcDcDcDcDcDcDcDcDcDcDcDcDcDcDcDcDcDcDcDcDcD
"}
